-------------------------E-o---------------------------------?------------------?---------------------------------------------E-----------------------------------------------o-----------------?-------
-----------------------------E---------------------------------------?------------------------------------------------------o---------------------------------------------------------------------------
---------------------------------------------------------------------------------?---------------------E---------------------------?------------------------------------------o-------------------------
------------------------E--------------------?-----------------------------?--------------?-------------------------------------------------------------------------------------------------------------
---------------o-E------------------------------------?-----------------E---------------------------------------o----------o----------------?-----------------------------------------------------------
----------------------------------?------------------------------E--?-----?----------------------------------?-------------------?-------?---------------------------------?----------------------------
--------------?---?--------------------------------?----------------o----------------?--E-?--------------------------------------------------------------o--E-------------------------------------------
-------------------------------------------------?----------------------------------------?-------------------------------o-------------?--------------------------------------------------------------v
-------------------------------------------------------------?-------------------------------------------------------------------------------------------o-----------------------------o-----------o---f
--------------?-----------o----------------------?------------?--------------------------------?-------E----------------------?---------------------------------------------?--------------?---E--E----f
------------------E-------------------o-----------------------------------------------------------------------------------------------------------?--------o----------E--------------------------------f
-----------?----------------------?-------------------?-----------------------------o-----------?--------------------------E-----------------------------?----------------------------------E---------?f
-------------------------------------------------------o-------------------------------------------------------------------------------o------?-----------------------o-?------------------------------f
------o--------------------------------?--------------?---------------------------------------------------?--------------------------------------------------------------------------------o-----------f
m---------------X------------------------------------X--X-----------------------------------X--------------X------X-----------------------X---------?-----X-------------X-----------?-----------------XX
XXXXXXXXXXXXXXXXXXXXXXXXXXXXXXXXXXXXXXXXXXXXXXXXXXXXXXXXXXXXXXXXXXXXXXXXXXXXXXXXXXXXXXXXXXXXXXXXXXXXXXXXXXXXXXXXXXXXXXXXXXXXXXXXXXXXXXXXXXXXXXXXXXXXXXXXXXXXXXXXXXXXXXXXXXXXXXXXXXXXXXXXXXXXXXXXXXXXXXXX
