--------------------------------------------------------------------------------------------------------------------------------------------------------------------------------------------------------
--------------------------------------------------------------------------------------------------------------------------------------------------------------------------------------------------------
--------------------------------------------------------------------------------------------------------------------------------------------------------------------------------------------------------
--------------------------------------------------------------------------------------------------------------------------------------------------------------------------------------------------------
--------------------------------------------------------------------------------------------------------------------------------------------------------------------------------------------------------
--------------------------------------------------------------------------------------------------------------------------------------------------------------------------------------------------------
--------------------------------------------------------------------------------------------------------------------------------------------------------------------------------------------------------
-------------------------------------------------------------------------------------------------------------------------------------------------------------------------------------------------------v
--------------------------------------------------------------------------------------------------------------------------------------------------------------------------------------------------------
--X---oEXX----XX?-X-X?o--oE--o--X?o---XX-?---XX?----?----oXE-----?E----EX-----------?--?--X-?--------o---?---E-oE------------?-oE--X-X?---XX----??---?------XX--E-X---?--o-XX--X?-E-------?----XX-XXXE--
--X--XooX-----XX---X--X-X----X--X-----X?E---?X-XE-?----o--X--E?-o------XXX----?------X-?XX---o?--------o----?---?----?-----XXX----XXXX-X-?X--EE?----E---o----XE---X?o-------XXXXXX----o----?-o-X?XXXX---
--X---XX---o--?X----XEX--X?-oXE-?XEX--X-E--?-XXo--------XX?-------------X?------------X-XXX-?-----?--------E----?--?---Eo---XXXo-X--X?E?XX--?-o---E----?---EE-XX--XEE--?----X--X--X------?-----X--X--X--
--oXoXX-E-X-oXX--X--XX-XoXXX-X?--XX??--X--E---Xo----o---?XE----?----?--X---o--------E?oXXXX-E-----X--X-----Eo-oE-?------X--E-X--X----X-XX?--oXXX?------------XEX--X-X--------XX?E?XXX?-o-o---o-?XXo-X---
--X-?XE-E-X-XXX--X--X?-XE-X---X--X-X----X----?XE--E---?-?X-oEE-?Eo-E-XoXX--------?o-XXXX-X-?--X?--XX-X--?-o---?-X---?----X?---X-X---o-X-X--o--XX-?E--------?E-X-oX-X--?o------XX?XXX--E-?-E---E-?Xo-oX--
m-X--X-o-XE-XXo?XX--XX?-XEXX-?X?-XX----?X-?--X-?XXX?-X?X-?XX---XXX-XXX-XX----E---?---X-XXXXEX?XX-X?-X-X-?X---E-X--o---?-?-XXoXXoX---E--XX-?-?-X-??XX?----E-X-X?--X?-XXXX---o?--XX-X---XXX?X--?--?XXXXo--
XXXXXXXXXXXXXXXXXXXXXXXXXXXXXXXXXXXXXXXXXXXXXXXXXXXXXXXXXXXXXXXXXXXXXXXXXXXXXXXXXXXXXXXXXXXXXXXXXXXXXXXXXXXXXXXXXXXXXXXXXXXXXXXXXXXXXXXXXXXXXXXXXXXXXXXXXXXXXXXXXXXXXXXXXXXXXXXXXXXXXXXXXXXXXXXXXXXXXXXX
