--------------------------------------------------------------------------------------------------------------------------------------------------------------------------------------------------------
------------------------------------------------------??--------------------------------M---------------------------------------------------------------E-------------------M---------------------------
----------------?------------?--------------------------------------------------------------E-o---------------------------------------------------------------------------------------------------------
----------------------------------------------------------------------------------------------------------------?-----------B--------------E------M--------------------?--Bo----------------------------
----------------------B---------------------------M----------B-------------------M------?-------------------------------B------------------o-------------------E---E--------B-----------------------M---
-------------------------------o-----E?---?------------B-----------B-----------B--------?----?--------------------------------------------------------?-----------------E---M---------------------E-----
-------------B-------M-------------------------------------E-------------------------?-----------B-----------M-------------------------E---------------------------------------------------B------------
------------------------------------------------------------E--------------------------------------------------------------------------------------------------------B---o--E----------------------?---v
--------------------------------------M--------------B---o----------------------X------------M--?-------------------------------o?----------------------------------------------------------------------
--M--?BEE---------------?---?MM-E-E------E-oB--B-------------?B-----B----------XE---M----B-B-B-oo---------------o--M-?oB---o---BXB-o-------o-B-M-X-----?--o----M---B--------------MB---B-----M--ME---?--
-o-----?-----M----B-?---?-E---X?---B---E-----E----oB------B--------E---XX-BM--X---o----o-B-E--------??B---oM---M?E-o-o-----oo---oB-XX-MM-----X--E--?-M-E---E------?-?E---------------E?---XM---B--------
-------o---------------XM--E-MX-B---E----M----M---?-----M-B?oB--B----?XXX?-?--BX?-----M---?BX-X---E--B--E--?------X----MB--oM------X------?XXX--X-Mo---M-------B------o?----------M----?o-X-XX--o----E--
-------E--B--?-?--E----X---M-Xo-----EB------?--------------EX--X-X----XX-EM--E-XM-?--X------X-X-----X-M----M---EEXo-----------?---XM?---E?-X-X-XM-X?------------B---?--B----E--B--E--MB?--?XX?-----MX---
-EoE-B--------Eo-X-B---X--?X-XM--X---E-E---EM-----E---M-?---Xo--X-o-M-XT--M-X--X--X--XoMMEXX--X-?----X-----E--EBM?X--M---?-MBM-M-BX--E----BX-BXX---X--BE-oE--Mo-E--?E-X-X--?o--B---o-M---o--X?-M--MXXM--
m-E-?EXX-EE--M-X-X-X---XB?--X-X---X-XM-BoX?X?-BX--------o-E-X-M-XoXM--X|X--X-XX-XX--o-X-X-X-oX--XX--X--X--XEoE-E-Xo----?X-B-XXoX-X-----?-o-X??X-B-X-XE---MXo--MX---EEX-oXMo---?E?-B-XX-X-XE--XX---?XX?--
XXXXXXXXXXXXXXXXXXXXXXXXXXXXXXXXXXXXXXXXXXXXXXXXXXXXXXXXXXXXXXXXXXXXXXXXXXXXXXXXXXXXXXXXXXXXXXXXXXXXXXXXXXXXXXXXXXXXXXXXXXXXXXXXXXXXXXXXXXXXXXXXXXXXXXXXXXXXXXXXXXXXXXXXXXXXXXXXXXXXXXXXXXXXXXXXXXXXXXXX
