--------------------------------------------------------------------------------------------------------------------------------------------------------------------------------------------------------
---------------E---------------------o----------------------------E-------------------------------------------------------------------------------------------------------------------------?-----------
---------------------------------?-------------------------------------------------------------------------------------------------------------------------------------o--------------------------------
----------E---------------------------B-----------------------------------------------B-M--B-----------?-------------------------------------------------------------?-------E------------------oE------
--o--------------------?----------------------------------------------?-----------------------?-------E--E----------------M-------------------------------------------?-------------------E----------B--
----?-?----o-------------------------------------------------------------------------------B-------------------?----------------------------------------?-----------?-------------o---B-----o-----B-----
---------o-------------------M--------?-----------------------B----------------------------------------------------------------------------------------------------E------------------------------------
--------------------------------o-------------------B?---------o-B-------------------------M----------------------E----------?-----M----------------?-------X-------------------E---B------------------v
--------M-----------XX---------------------------------------------E----M-M-X---X------------------------------X---B------------B----------XXB--------------X------------------------BB----------E------
-----?-X-----?----X?X------??------------E?-----o--------o?--------E--o-X-?XE--XXX-----o-oX?Xo-o-----?--XX----X-----M-X----------?-?--?X----X----XXX-------X--X-?-?--oEo-o--Bo----E-------?------??--X--
--XX--X?E--?-XXo-?-XX---E---?-------o------??----EE-----E-----------XXX-XXX-----XE---------------oo-ME??X--X-XXoo----EX-----E-------------XEX-o---X--------XXXX-XEo-Eo-oo----------oo?-----?--o--E-?oXX-
--EX?EXE-?E---XXX-??B-X----o---o------------XE?M--o----E-------XXE---XXX-?X-??---X-o-----E?EX---?-----X-X---XXo--?--XX---?-?--------o-B-X-oX--?-oX----?-----XXX-EX?o--?-o-X---?-E-------o--E-o--?-----X-
--X--X-X--o--X-XE---XX-X-E---?--?-E?--?XX---XBX-X--M--o-oE?o-M-XXXX-?XEXBX-?-X---?X--------X-------E---X-X-M-Xo---E-oXM-E-----o------?--E-X-X--XX-X-?X------XXXE-X----XX-X---?--?---o-----------?---?X--
---XXXX--M?--XXX-Xoo-XXXToT--E--T-----T-XX?XXX-X---EX?TE---o-o-oXX-XXX--X?--XX--T?X-o-X---?XET---?-EE-?-?-X-T-X---?-X----?--E--T-?E--?--TX?X--oX-?X?X--o--?X?XEX-o-X-XXXX?--------?----T----?T----E-TXB-
m-?X--X-XX|?-X-XXXX-o-XX|X|?----|---X-Bo--XXEXXo---X|-|--??B-|o-oX-X-X-XX---X?-||-?X|X|o|XX--|??-------X----|--X---X-o-o--o--Bo|--o-E?--|-X--XX?-oXX?|-E--X-XXXXX|X?|X-X?X|--o--Eo---E-|XX--E|-?---?|X|-
XXXXXXXXXXXXXXXXXXXXXXXXXXXXXXXXXXXXXXXXXXXXXXXXXXXXXXXXXXXXXXXXXXXXXXXXXXXXXXXXXXXXXXXXXXXXXXXXXXXXXXXXXXXXXXXXXXXXXXXXXXXXXXXXXXXXXXXXXXXXXXXXXXXXXXXXXXXXXXXXXXXXXXXXXXXXXXXXXXXXXXXXXXXXXXXXXXXXXXXX
