--------------------------------------------------------------------------------------------------------------------------------------------------------------------------------------------------------
-----------E--------------------B--------------------------B-----------------------------?--------------------------------------------------------------?-------------M---------------------o-----------
----B----------------------------------------------------------------M--------------------------------E------------------o----------------------o-------------?-----------------------------------------
--------------o------------------------------------------------EE-----------o------------E------------------B----------------ME---------------------------------------------E---------------------------
-----------------------E-------------------------------B-------------------------M-----------------------------------------------------------------------------------------------------------------B----
---o-------------------------?--B-----------o-----?--------o-------------?---------------------------o----------------------------o--------------B--o------?---E----?----B------------------------------
--B--------------------?------------M-------------------------------------------------------------------------------------B------------------------------------?----------------------------------------
---------------------B-----------------------------------------?-----------------------------?--------------------------------?-------------------------o---o---------------------------------X--------v
---------------o------E-----X----------------M-E-----X--------------------------------------------------B-----------------------------------M---?E--X------o-----E---------------------------X--E-------
-------E---?---XX?-X----oEXX??-XXX--XX-?----?--------XEX---Xo----E------?----------??-----X----oXXXB--EE---X-oo-??--?B-------?-o-??---?E--?----E---X-?----------??-----?-?--?--?------X-XB-XX-----E---o-
-o--Eo---------Eo-XX?-----XX--E?X?-BXEX-o---?E--------X---oX-------E---?-----E-?-----?--E-o----?XX---------X-----E--BE---?----?-?---E?--------------X-?----E-ooE------------?----?---?XX---XX----?--?---
----?---?-----?-XXX--?-o-E?XE----X?E-X---?-E-E-?-----XXX-XX-XX------Eo--?--E--------X-?--XX-E?B?-X?-o-E-----X-BB----E---E---?E--?-EBE-------?--o---XX-------o---?---o---EE---?E--------X----?------?----
------?MT-----X-XX----M---X--X-E--X-X-?E-----------o-X-X-X??XX-XXE-------------------X-X-X---?--X?XEE-o-X?-XoEoE------??------XX-X?-?o--?---?-E---XXX-X----o-?oBo------X--------o-?-----??MX---------?--
-E----o-|--T--XXX---??T--T-XXXXX--?X?--?---?-|-------oXTXoXXX-oXXXXT--?-----o----EE--oX?XT-----?-XXTE--XXo----E------?T---ETXX-X?X-T-?------T-?To?XXX-XE-E-?-XX-XX----XXX-?--?-----M-?XE-XX-ETT?-o------
m-M??XoX|--|--X-EE--o-|-X|M--|X?-o--X-X|E--|?|-o-----X-|?X-X|X-X-|X|E-B--?--XE|X---X-XE-X|-?--|--XX|??--X-?-??o----o--|---||XXX---X-EE?B?o--|-o|X-?X-XX-EXXX-XX-Xo?----X-X|?-XXoE-----X---XX?X|--E---?o-
XXXXXXXXXXXXXXXXXXXXXXXXXXXXXXXXXXXXXXXXXXXXXXXXXXXXXXXXXXXXXXXXXXXXXXXXXXXXXXXXXXXXXXXXXXXXXXXXXXXXXXXXXXXXXXXXXXXXXXXXXXXXXXXXXXXXXXXXXXXXXXXXXXXXXXXXXXXXXXXXXXXXXXXXXXXXXXXXXXXXXXXXXXXXXXXXXXXXXXXX
