|-T?---E---XE-?ET--XMoEB?-o-|--T|T|---E--B-?--EM----?---|--?|-?X--?-X-X|??E?-?--|-T-|-XM-----?-E----EBo--|-----E----o---o|-----o---T-T--E-o|-o--M-?---|-T-?o--o----TM--BTX?E---TBB---EBoX-M-TM|oo-T----B
M--|E-X--oT-X----ToTo--E-T---?-|BMT-----M?--MEE?------X-T-||-?--o|-X----------o------MBE---------------X-T-M-T---|E-MT-E-----XoM--TE-----?XT--X-TMX----E--o-?B-M---MB-ME-----o-M?--BM-E-XMo-X-o-T---X--X
B-T---MM-MM----B-M-M-T--o-o-|o-?---MTX---M-EEB-XoT-M---MT-T-o---|-E-E||T-X-X-B-||E-?-BT--|-|T---M--?---E-M-XMMX----?---E-B-?X?TB-?E-o---Bo--o----|-o|EM--|B---EE-E---MEoMXM--ooB-?-|T--------T------T?TM
M---X----E-------|-X----B-BX-X----M-T-E-T-?-E-?-----B-BB-M---X---T---M-MoB--EE--?-T---|--EE|--|-|-|-MEB-?--oE-----XT---E??---oE-|TXXoT-ETM----B-X-?--X---E|----M--B|E-oX|-MT--M--?-----|----o---o?-M-M-E
BBT----E--MX-o---E??E?TE|-oEo?-Mo-B|--EoT|--M-?o-?-T--XBM?-M???-------MM-----o---?To?T-X---X?-o--M-X--TE-oTo--?----|Xo-EX--o?M-T-M--X--X--T-ooT?o?--T--Eo--o-MTo-E?E--------B?-|-|?-?|XE---B---?Bo-E-EB|
M-TT---?BB-XX-M----?|B---MEM-|E----?-M-XT---?-M---|--EX-XB|?----BX-T-X-------X-?--T-?|---|-X-------XXT-o-X-ETE--XE--o-?oT-T-?--|-M-?-o--|--|-------MMM|Xo---|--?--E---?T--?X-X|-Mo--TM?|-oBX-T-|T-?----E
||-M---?o-----M------?-|T---T|--MT-T-?--B?E--TMXX--M----B|------oo--|o-MMEE--o-|---M-|--|B---M--M---------?-------T------EX---o--|-o---EB|---oB-E----E---M-?--M|X--MB-?|-T-X-|T?--B--oB-X----To-E----T-X
M-|--B--XEo?------|--Xo--MX-X---o-||----B-MMTM--B---B|XE-o--o-|---E---T---B-----E|-----B---oM-??M-MX---T-oE|---oToX|--T-T---o-BTE-?-|-----?--B?X--TB--X-BM-M---TBE-X---BM-----|-----M---X--------E?-B-|v
TM-------oX--B-MBB--|--T-o-M|Bo-E-B-X--ooo---M--o-X--T|X?B-M-----T---|--B--------?-E-X-|XM?--|-|-|-B?-----?-----B--|--?--oXMo-T-B-MX-EoX--M-oB?--oT?------o----o-|XT--o|--X|?MEX--------o-oE-|E|X--|-?-|
B-E---oT|XMM-BXMo-Xo-X-M-TXo-B-ME-M|----------XM--X--MoBo-T-B---------?B-T?-o--MBoMT-oB--|-B--M-?|EX--M---?---oME-ME--B-----oMT-o--|-To?oB?EB-EB----|----E--|----oM-??-?o-|-T-T--?oT-B---o---X-TMoM-oMB|
??----o------TX--To--|XX-------?--B---X-XE-?T-oo|o-?MM--?-E---E|To--B||--B-E-E-o--M---XB-----B--?-BEEM------T--E---T-X-X||-|--T--T-BX-ooo----B|-XM---MTM-TX-B--EE-??------|-E---o-------MEoX-E-B-----?-T
E-oT-----BB-E|M-TB-XTE-B-E-----EX-|-o-Bo---T-BE----M--|--T---?---------o--B-B------M---B--?T--MB---|-TEo-?B--Mo|-?-BE|-|TE--E-----TMo----M----|-M|M-|---T-----TX-----o-?--T|o-o---XT-BBX-EEX-??o?oT--?MB
ME-B--M-M--T-M--|B?|oTM?---T-X|Bo?--?M--B-----To-oM---|TM--EEB?----E--T--o----E-----TB-X--B------M-XB-X-TE---------B-X|--BET-MX-|BEB-----B---X-----X?--M-B-oE|---------|X--?----X--METoE-B||------X---TX
M-X-BT---B-M----||-Eo---|o-M-E?|BX---E--T--T--B----M-|-BX?-ME--o-EX-TE-------oT-XXEooB-o-?TBB?----MB-?T-EM-|oMEX-MM?MM--TET-----BM--X------X-|--|TB---B??-M-MX-X----TB-TX----E-E-E------?EB-X?-|-EoMBM-o
m||o--T---E-|E---TT|-X-Xo-T---M-?-?o--TB--X----?-E--EX-M|-|-XEM--MM--?-B--BoBE--TM--X-MMX-|-X|T--?T---TX|?-BT--|B--BE--X-?o-M-|-oo---------o----oX---E------?oX---TTTB-BT----T-TEE-o---o-B--?---o--X---?
XXXXXXXXXXXXXXXXXXXXXXXXXXXXXXXXXXXXXXXXXXXXXXXXXXXXXXXXXXXXXXXXXXXXXXXXXXXXXXXXXXXXXXXXXXXXXXXXXXXXXXXXXXXXXXXXXXXXXXXXXXXXXXXXXXXXXXXXXXXXXXXXXXXXXXXXXXXXXXXXXXXXXXXXXXXXXXXXXXXXXXXXXXXXXXXXXXXXXXXX
