---?-B?----B--------o-B--X--ME----------X-----?M-E--X-----------------------------B----M------------?----X-B---------E----------o----------------------------X-----------------X-----M---?-BB------M----
----B---B----B--------B----E------E-------------o--M-----XB--------?------o---------?---E-------o-----------------?-----MB-----X-X----XB----E---B---------------------------------------?---M-----X-M---
-------?---B------B-----o---M--MB-B-X-M----------?------?-----?----------M---------------M---B------Eo---?-------M-----------------B--------X-o--------?--B?--o--E---Eo-------E------------B------B-----
-----o---------B---?M----?------o--------------?-BE---X-----------------E---E?E--EB-------M--oM-B-----------------X--BMX-----------o---X-XM----E-----B-E------EE----E------B---o------------------M-----
-------?-??-----------------E---X----------B-o-M--------XX----------------B-o--E-----------ME-E?-------o-----------?-------------------MMX---------------------oME-----E---------B--o------E---o--E--X--
-B-----o-----------M------M-----------------X-----------X----B-------------------------M--------?------------E-----?--o-M--o?X-------------------o--o------?--------M-E-E-Xo-------M----BM----------X---
----M--------M-B-E----B-------o------------------------o--o---------?---B------X--X---X------------o---------------------------E-o-X--o------X?---E----------B-BX--X---o--B?X---------B----M------------
------------------B-----------?-------o----X----o--BX--------------M--o------XE---E-----M----------B--E--M-----B------oE----E--------X-B-?---M----------o-----?----M-X---B--------E--Eo?--?------------v
---------------o--------------?--o--------XM----B---o-------?-o-E-----------B----------E-?oMB-----BX--EX-o-----------X---------X--X---------E------------?E-?-E-------B-o--------------E----M----------f
-----?-B--------BE-B----B-----------M-----------E----X-M------?----Bo----------?----o-------------o--E--?------------?------o-----------?-?-B----?---------M-X---------X--E----B-------??Bo----------oof
-----E--------M?----------o------------------M-------B--------------------B---------M--B-------?---------------------B-----X---X---------o-------M-----------------M------M-----M--?-------o?----------f
-B---------B---B--M-----M---E----------M-----------?---E------X--------B------M-----E-----------XE----?----------E--------oXoBM----------------------o-B----?------------EX----B-----------------------f
--X-----X----------ME-o-----E-----?---?---------o---?-X------X------o---E-----B-----------------------------------M----------------o-XB-----o-o?------?---E-------o--Mo---------E-----X----------------f
--M------B--------M--------------?--MB-----------------o----M-----M-----------------M-?---------o----E---M----?---?-----------o-o--X---BX------X-----?----o-o----?--------------?----E----E----X---E---f
m-o--Mo----------BX------X-----M---M--------------?--------------?X--?o-E----B-|-------B------M------------?--------?------------------M----------o--M----------------------------M-M-|--?B------X--|--X
X?XXXXXXXXXXXXXXBXXXXXXXXBXXXXXXXXXMXXXXXXXXXXXXXXXXXXoMXXoX????XXXXXBXXXXXXEXXXXX-XXXXXXXXXXXXX-XXXXXXXX?XXXXXoBXXXMXXM--XXXEXXXXXBXXXXXXXXXXXXXXXXXXXX-EXXXXXEEXXXXXXXXXXXXXXoXXXMXXXXXXXXoXXXXXXoBoXX
