-------------------------o--------------------------------------------------E-------------------------------------o------------?-----------------?------------------------------------------------------
------------------------------?----------------?------------------------------------------------------------------?-------------------------------------------------------------------------------------
---------------------------------------------------?------------------------------------------------------------------------E?--------------------------------------------------------------------------
----------------------------?---------------------------------------------------o---o-----------?-----------------------------------------------o------------------------------------------?------------
---------------------------------------------o-------------------------------------------------------------------------?--------------?---------------------------------------------------E-------------
----------------------------------------------o-----o----------------------------------------------------------------------------------?------?---------------------------------------------------------
----o------------o------------------?-----------------------?-------------?--------------?------------------------------------------------------------------------o-------o-----------------------------
---------------------------------------------o---?----------------------------------------------------------o-------------E---------------------------------o----------------------------------------o-v
-----E---------------------------E---------------------------------?-------------E------------------E-------------?o--------------------------------------------------?--------------------------------f
-----------------------------------?--------------------------------------------E------------------------?----------------------E---?---------------------o---?----------------E---------------?-------f
-----------------------?-----------------------------------------------------o--------------------?----o-------------------o--------------------------------------------?E-----------------------------f
-----------?-----------------------?--------------o---o--------------?-------------------------o-E----------------------------------E-?----------------------------------------------------------------f
-------------------------------------------------------------------------------------------E-------------------------------------------------E---------E---?--?---------------------E------------------f
-----------?-------------------------------E------------------------------------------o-----?------------------------------------------------------------------------?---------------------------o-----f
m----|-----------------------------------------E--------|-||----------|------?-----------|---------------------------------|----------------------|-----|-----||----o--o---o---------|-------------o---X
XXXXXXXXXXXXXXXXXXXXXXXXXXXXXXXXXXXXXXXXXXXXXXXXXXXXXXXXXXXXXXXXXXXXXXXXXXXXXXXXXXXXXXXXXXXXXXXXXXXXXXXXXXXXXXXXXXXXXXXXXXXXXXXXXXXXXXXXXXXXXXXXXXXXXXXXXXXXXXXXXXXXXXXXXXXXXXXXXXXXXXXXXXXXXXXXXXXXXXXX
