--------------------------------------------------------------------------------------------------------------------------------------------------------------------------------------------------------
--------------------------------------------------------------------------------------------------------------------------------------------------------------------------------------------------------
--------------------------------------------------------------------------------------------------------------------------------------------------------------------------------------------------------
--------------------------------------------------------------------------------------------------------------------------------------------------------------------------------------------------------
--------------------------------------------------------------------------------------------------------------------------------------------------------------------------------------------------------
--------------------------------------------------------------------------------------------------------------------------------------------------------------------------------------------------------
--------------------------------------------------------------------------------------------------------------------------------------------------------------------------------------------------------
-------------------------------------------------------------------------------------------------------------------------------------------------------------------------------------------------------v
--------------------------------------------------------------------------------------------------------------------------------------------------------------------------------------------------------
---o-?----oE?-B--?--o--M----?-B-B---B-oE-----B----------?-E?------oM----------?--------E------o------B--B----B--------?-----oM---?-?---E------B--X----oM--oB-B?-----------E------??--MM-?-------?-------
-----B--------o--BB--?----B--?----BMM-X-----o------Eo---?-ME--M?-------------E---B--?----oo-E--oE-M-?M---------MoE---------EM--EBE-B--------B?---X--o--M-----o??-B---oM?--B--?---?---M?M---------o-Mo---
--o-?------E-----M--M-----E--B-------XXX----E-?-?-----?-E-E-M----MEE-B-?M------M-----o-E-E--E-----E----E--XX----------E--------Moo--B-----E--ME??-X-M--MB-----E-BXMMM-??E---B------?---B--------EM-M----
-------B--E--BXE----BEM---------------X-X-o-X-M--?-----o-?--o------o---M--o--M-M--ME------Mo-MM-----B--B---X--B------B-?--E---M--EE-M--oo-------ooX----M--M-?---B?X--M--------E---o------?-o----E-------
--------MXXXE--XB--?-EE---o--M-EM?o--?-X---X-E-B-?XX---------BX-B-M?X-B--BXBE-----X?---E----Mo--?ME--?----M?X-B-E----EM-B-o-o-X-XE--E---o----XX?oXX------E-----?-XoB---E----------o--X-Bo------Mo-------
m-o--?o?o-XXo---XE--XXo-X-o?-----X--X---X-EXX??-M-XX-----X--o--XX----XX-X-XX----oX--E--E??--M-EB---oE?---X--XB?--X-?--o-o-Xo-?EXX---B-X-Xo-BX?-XX-X----XMX----X-X--XX?EM-o?--Mo--X-M-X-X---BXX--X?o-----
XXXXXXXXXXXXXXXXXXXXXXXXXXXXXXXXXXXXXXXXXXXXXXXXXXXXXXXXXXXXXXXXXXXXXXXXXXXXXXXXXXXXXXXXXXXXXXXXXXXXXXXXXXXXXXXXXXXXXXXXXXXXXXXXXXXXXXXXXXXXXXXXXXXXXXXXXXXXXXXXXXXXXXXXXXXXXXXXXXXXXXXXXXXXXXXXXXXXXXXX
