--------------------------------------------------------------------------------------------------------------------------------------------------------------------------------------------------------
--------------------------------------------------------------------------------------------------------------------------------------------------------------------------------------------------------
--------------------------------------------------------------------------------------------------------------------------------------------------------------------------------------------------------
--------------------------------------------------------------------------------------------------------------------------------------------------------------------------------------------------------
--------------------------------------------------------------------------------------------------------------------------------------------------------------------------------------------------------
--------------------------------------------------------------------------------------------------------------------------------------------------------------------------------------------------------
--------------------------------------------------------------------------------------------------------------------------------------------------------------------------------------------------------
-------------------------------------------------------------------------------------------------------------------------------------------------------------------------------------------------------v
-----?-----------?------??-----o?E?---?------?-E---?--E--o-?------------?---o----------?--E----?--?-E---?-----E---------?--o-?------?--o-----------?-?--o----E-o---o?--------?------?-------------?-----
--o-??-?----oE---?-?-o-?-o-?---EE---------?---------?-----------?---oo------o----E?--?----------------------------E-?o------o------?--??E---?-----o-----E---EE-----o----?--------?---Eo-?-----?o-----oo-
-------?--oo-----?---------------o------o------E-------ooE-------oo--E-?E---o----o-?--?--------o-?-?-?------E---------?----------o--o---??-----------?-----?-?------------------------oE-?--------------
----E--------------?---E-?----?-----o----E--?--?---------?--?---E--?-----E-E?---------------------------o---?---?-Eo--------EE----??------------o-?----E---?--------------o------?--??--?---o??--E------
---oE-------------------?-------------o------o??-----?-----------?------o?----------?-----E---o?----?------------E-----?-------?------o--?-----o-o------------------?------------------?-o--------------
----------------E-?-?--------------o-?------------------------?-?---?-----E-----o-------------?--E------?-?---o--?-E--------?------------??-?--E-?---?------?-o----E------??E----------?--?-------------
mE---X-X?-|?-X-X--X?|---E---?|X-XX?|---X||---|X--o||-E-X|-o-XX-?XX---X-X--XXXX-X--XX-X---?EXX----XX---XXE-X?E-EXo|X--X-|?|X-?X?XX|--?|X---E|--X--XXX-XX----X-X-|-|o--X-----X-|--XXXX---X----E?X?---|--X-
XXXXXXXXXXXXXXXXXXXXXXXXXXXXXXXXXXXXXXXXXXXXXXXXXXXXXXXXXXXXXXXXXXXXXXXXXXXXXXXXXXXXXXXXXXXXXXXXXXXXXXXXXXXXXXXXXXXXXXXXXXXXXXXXXXXXXXXXXXXXXXXXXXXXXXXXXXXXXXXXXXXXXXXXXXXXXXXXXXXXXXXXXXXXXXXXXXXXXXXX
