----------?B------------M-B------------B----------M--o---?-E---E-?B-o---X--E---------------o-E-B---o-X---M-----?-Eo------M-o----------?-----?---------B-----?E-----Eo-MX-----------B---------?-E---X----
-oX--B--E------E------------------M--Xo--M--------o--o----B-------o-?------?--X---MB-------E-o------------o-B-----------------------Bo---------M------------------B-------?-----------?-----------X-B---
--X--------------------------o--X-------M---o-X-------------------M-----------BX---X---o--------E-----------------------B--------X---M-----o-----------E----MX--B------EE-------X----------E--o--M---ME-
-------------EE-----B----B------?--------?M---------------B-o--E-----?-----E-----X--?----------o-?-----M-B?---M?--?------E----o------XB?---------------E---o-------X---------?-----M-----EBB------------
--B---B-----?----------------o--------E------?---------M--------?---------E-------?--XM--------M-------E-----o-------MB---?--o--E----------------------o--?---E-o-------B----X-----------?-----M-BE-----
----B------X-------X------------X-------M----M-X--E---------E-----M------o-X-B----X-----X---------------o--o--------B---------------EM------B--------oB--------o---o------X-X--ME?-E---ME---------------
--------E-------BE--------X-?--E-?-------o---------E---------------B-B----o-------M--------X--X-----o--o------------o-----------B-------E---EE----X-----E-?-----E--X------X---------------M----o--------
----o--------o-B----------------E--o--E--------?----X----X----------M-------------M------------o-----?------?------X------MBM-B----X-o-MX--------??-E----B--------X--B--Bo---X----------o----o---------v
-E-------------E--XX--------M-EM-----B--X----------------B--------B-X---E-----------o--------o---------M-----------E--------E?--------------B-------------E-oE----?-------B------?----M?------M----MMEXf
------------BM--X--------X---------o-----X---------?-----B--------X----o--------E-----B------------X---------------------------?-------M---------------------------?-----E--------------oE--M-------XE-f
---------M----M--M-M-----o---o--E-oE-----o-X----oM--B-----XE--------?-o--E------?------------------E--?---------------------------?----XM------?----M-----------------------?------B-E---------------M-f
----------------E----X-o----------X--------E----X-----?M--B--?o---------------M----X--X-----X-E--M-M-------------E-----M-?----------M---------------ME-----------------E----------XEE----------------E-f
----M-------------BM-------M-------B-M--M------------------M--?--?---E---B--?----------------?-----------o---------o---------------------X---Mo-----M------M--------E---B-BMX----E-------?-----B------?f
-----E---------------------M------------------------------B-M------E-----------o--------B--B---------------o--------------?----------X-X-ME-------------B?--------EB-------------X----------------?---Mf
m?------o-M------------o---------X---------E------------------------XX---------------|B-|--------MB-------M?-----E------|------------|---oM?-?--------B-----B--|------M-------|-------?-------?-----X--X
XEXXXX-EX?XXXXXXXXXXXXXXXBXXXXXXXXXXX?XXXXXXXXXoMXXXXXX-XXXEX?XXXXoXXX-XXXXXoXXXXXXXXXXXMX-XXEXXXXXXXXXXXXXXoXXXXXXXXXX?XXXXXXXXXXXXXBXXXXX-MXXXXXXXXXXXBXXXXXXXXXEXXXXXXXXXXXXXXXXXXXXXXXXBXXXXXXXXXXXX
