--------------------------------------------------------------------------------------------------------------------------------------------------------------------------------------------------------
--------------------------------------------------------------------------------------------------------------------------------------------------------------------------------------------------------
--------------------------------------------------------------------------------------------------------------------------------------------------------------------------------------------------------
--------------------------------------------------------------------------------------------------------------------------------------------------------------------------------------------------------
--------------------------------------------------------------------------------------------------------------------------------------------------------------------------------------------------------
--------------------------------------------------------------------------------------------------------------------------------------------------------------------------------------------------------
--------------------------------------------------------------------------------------------------------------------------------------------------------------------------------------------------------
-------------------------------------------------------------------------------------------------------------------------------------------------------------------------------------------------------v
--------------------------------------------------------------------------------------------------------------------------------------------------------------------------------------------------------
--?-----??---B-----E-MX--M-------------MoB---o-M--o---BB--oMo-?----oX--BBM-B-B-------X--?----?EM?B-B--EEBM-E-----M----B--o--B-?-----B?----o-o------E-------E-MM?---BEX----M--oooB--o-------Bo?----------
----E-M--ME----o--E?--?X-M-------?EMB-----?-------E-------oo--?-E--X?-----?----?M--XX?---B---B--?--E---M--M--?----?--B-B-oBB--?---T----MM----?-----Mo------?o-----M-XoX----X---BXMX----?----?-----------
----E-BoMoM------?------X---B-B-E-M---M-------E--E-----E---Moo-----EXX---MMT-BEM-?-X-XMo--------?-B-------?----M------------T-----|-------M-M--E-MB?----E---o-----XX--Xo-EE-XX-X-EXX-oEB-?--------------
----B-MB-----T--T?-T?o---X---ME------o------?--oMB--E-B-------o---o--X--B--|-----?BXX--o------?---M?T-oE---?E----B-EB-oo----|-----|--B----M-B?--T----T-----oE-----X--X-B??---X-XBEXX---------T----------
-M-X----XXX--|--|-T|---B-X-------MT-X--T--T--?-T-TE-?----oT-?-TTT---E?XXT--|--E-BB-BXX--BoE--oT---T-|M-M--M-?-----BT---E--TB|-oTT?|-T--o-E-T----|----|-Bo---X-TT-X-?BXE?------X---EX--MT--B-T|----------
m-X--X--X-X--|-X|-||---BXB-------X|--X-|--|----|-|--XBBX--|BXX|||-----BX|--|-X---XXX--X----X-X|---|-|---B----BX----|-----B|-|-X||-|B|---X--|-X-X|---X|-XX-XX--||-XXXXX--X------X--XXX--|----||----------
XXXXXXXXXXXXXXXXXXXXXXXXXXXXXXXXXXXXXXXXXXXXXXXXXXXXXXXXXXXXXXXXXXXXXXXXXXXXXXXXXXXXXXXXXXXXXXXXXXXXXXXXXXXXXXXXXXXXXXXXXXXXXXXXXXXXXXXXXXXXXXXXXXXXXXXXXXXXXXXXXXXXXXXXXXXXXXXXXXXXXXXXXXXXXXXXXXXXXXXX
