--------------------------------------------------------------------------------------------------------------------------------------------------------------------------------------------------------
----E--o---E?------------------E---o---------?-----M------MB-M--o-----?-M-o-----B-B-----??-o--------------M-E-------------------o-?----?---?----o------------E---------------M--------------?-----------
--------E---------------?----------------------M------M------------------BM-E-o---B-----------M------------------EBM-M---?---E-?-?-------B----?---------B----oMo-----o---------------o------------------
----------B----EE---------Bo-------------o-----o-----?---B---E---------------------o---o---------------M----MB-----?---------?----------E----M----?-?---o---B------Eo---EoB-?--?----------B-------------
---M--B-?E--------?---M----o?------B-----E-?-M-----BE--B--M?----B------E-----------E-----M-----M-M?-o----E--?o--------E-o--------oB--E---?------M----B-------o----B-?M-o----M-------?---B---------------
-BB-E-------E--B---E-----B--M-----B--B-------E----------B--------E----o------------E----?-------------o----E---------BM-B---------E---------------o--------?-----M---E-------o---o-E?--B-o?-BM----------
---------B-------------?--o-M--EEo--M--?E----E-----------B----------E---?--M--oo------o------?-E------o-----------E--o--Bo---o-------oM------B-----E------o----------B--B-?-B-----o--B-M----------------
----?------o--------o----?--B------EM----?----E---oM----B-----MM---B-----E---oM--B----------------M--------M-------E-?------ME-----oM--B-------B----B----o-------BM-------?-M--------o-----------------v
-----------B-------M-------M--E---------??----?-----Bo------E-----E-------|-----E------?-------E---B-----M-------M---BE----o------------B------?--B-E?o-E-B------------M---o?---o----------|-----------f
--E-o-------o------?---o-------?E?B---M---------MB--M-B---M-----B----B-B--|-E--Bo--o-Eo----?-----o?--oBo------BM--?-------M-----E----E-B--?o------?---?B--E--o------B--MEB-M---?----?-?-B--|-o---------f
-----?----M------oE---?---?----M--B-M--B-??--B-o----E--M------M-E-?-----?-|-M----M-----------E--?--M---B-E--ME-----o---E--BE-?E-M-EM------?--?-?o--B--?---E-?MM----ooB------?----B--M---EM-|-M---------f
-------XX-B--E--?M----M---o--XE---oo----|---E---oE-?--E-M----BE---T--?E---|-o-BB----o------?|-----------E---------To-|-----o--B---M-Mo?---o----?---------?-M--?--E-----M----o-------T-----X|-----------f
--|----?----|-|--?-o-------XX?-o----|-|-|TM---EoM-E?o----|-|-EoB?-|-------|---E-------oX--M-|---B----?---?---BB?--|--|---B-MX--o----T------o-----To-------MoT-----T-X-----E|-MEMEMM-|----XX|-----------f
--|----TB---|-|---T--B-|--T-XME-T-E-|-|-||-T-oM---T|-TBX-|-|-EEMT?|----X|-||--ET|-T-T--X-T--|-|--T-ToTMBTo----oT?o|M-|--MT|--o-E-|--|-TBE-|-TM---|E|-To-E---|-|---|--XM-TT-|---TB--T|-|-M-M|-|---------f
m-||-X-||-XE|-|---E|-XE|-B|-X-MB|-|-|B|oE||-XBX|-|o|-|-XM|-|-|-X|-|--B-o|-X|--o||-|-|-|-X|--|-||BXM|-|-B|-oX|-X|-X|-X||-X||-|-X|-|--|-|-|-|-|--|-|-|-|--X|-E|||--X|--|M-X--||--|-|-||-|-|-X-X|---------X
XXXXXXXXXXXXXXXXXXXXXXXXXXXXXXXXXXXXXXXXXXXXXXXXXXXXXXXXXXXXXXXXXXXXXXXXXXXXXXXXXXXXXXXXXXXXXXXXXXXXXXXXXXXXXXXXXXXXXXXXXXXXXXXXXXXXXXXXXXXXXXXXXXXXXXXXXXXXXXXXXXXXXXXXXXXXXXXXXXXXXXXXXXXXXXXXXXXXXXXX
