--------------------------------------------------------------------------------------------------------------------------------------------------------------------------------------------------------
--------------------------------------------------------------------------------------------------------------------------------------------------------------------------------------------------------
--------------------------------------------------------------------------------------------------------------------------------------------------------------------------------------------------------
--------------------------------------------------------------------------------------------------------------------------------------------------------------------------------------------------------
--------------------------------------------------------------------------------------------------------------------------------------------------------------------------------------------------------
--------------------------------------------------------------------------------------------------------------------------------------------------------------------------------------------------------
--------------------------------------------------------------------------------------------------------------------------------------------------------------------------------------------------------
-------------------------------------------------------------------------------------------------------------------------------------------------------------------------------------------------------v
--?-------E--?-o-Eoo---?-E-------E-?----------??----?---E-----??--o----E-?--?-?---??-?-----??--------E-?---?--o------E-------------?-o----o----?--------o-------?----E-----?---E-E--o--E---E--?---------
-------o------o----o------------?-?-----?-------Eo---------------E------?--?--o----------E--------o?----??E---E---?-?-----o-E---------o?----?o--------o---o-o-o-----?-?---------------o--E--o-??-Eo-----
-?--------?----?--?---?--E-----------?---o-o-------??----?o--?-o---E-----------E-?--o-----------?E--E-------------E?--?-?-?-E--?-o--------------?--------?-?--E?------o-----------?---o-----?-----------
-E-E-----o----------?--------?---E----------?---?-?------??---------o------o------------E---?------------E--?---------E----o?--?o-EE------E------??--?----?-?-----------?---?---?-------oE?-----?-o-----
-o--------E?--o--o----------o------?------E----E--?----o-----???E-EE--?------------?------EE?E-?-?o---------------------------E-------------oo?--o--------?---o----?----?-?------E---?------o--?------?-
-----o-E-----o-?----o-----?-o-------------?----------------o----?-?--o------?------o----?-o-E------?--o--?--o---?-EE?---------?---------------o?---------?-o------o?---EE---------------o---?----?--???-
mE--X|--X--|-?|X-----XoXEX-X?X?o-X-X?-??-|--Eo|-X-X-|-X-|-XX----X|E?X?X--X-X-EEX-----XE--X|X-X-X-X---XX-?|o--|E--o?-o?X---?-o?-XX-E---X?---X-?-XX-X------XX|XE--X|o---o-XXXo--X?|X?E-X|-----?X??X|XX?---
XXXXXXXXXXXXXXXXXXXXXXXXXXXXXXXXXXXXXXXXXXXXXXXXXXXXXXXXXXXXXXXXXXXXXXXXXXXXXXXXXXXXXXXXXXXXXXXXXXXXXXXXXXXXXXXXXXXXXXXXXXXXXXXXXXXXXXXXXXXXXXXXXXXXXXXXXXXXXXXXXXXXXXXXXXXXXXXXXXXXXXXXXXXXXXXXXXXXXXXX
