---E--------------------------o--?---------------E----E-B--B------X----??MB---o----------o-o-------------------------X----BB---X------------?--o-----------------------??-----B------------------B----E-
------E---------oE--------BM------------?-------E----------E--?------------B--M-------o-----MoM--M-E-o-M---------X-------E------------------?---------o-X--B-----------BE--B----------------------------
---------------------E--oo?-----X-----------o--------E--------M-E---------M------E-E------------------M----E-------------------------------M------------------------o-?X--------B---X----------M--MXX---
--M--X--o------E-X--o--o---------E-----?------B-----E---X-E-------X-E?-?----------------o--X-----o----o---M---M-------------o----B--oo--------M----------B-----M---------------M--o----------M----------
-X------B-B------B-X-------------------??---?---------------------E-----------o--------o----o----o-M-----E-------EBM----?---X---M-----B-------X-EM----------------E--------E----MBE-----M?--------------
-----X-----------------E-EM-----E---o-X-M------------BE---?-------M-----------BE----M---B---?---E-M--?-E------o----------X--------oX-------M-------M----------XE--EX----B---------E-MX--o-------------?-
----oMM--------B------E-X--X---B-------X---------B-----E----------o?--X------B---?-o--X-E----?------------B---------E-------------B-------Xo?E---o--------------B----X-------------X---E---------M----B-
------------------------M-------X---------M--------E-----------B---------XM------------X-----------------M--------E-E----o-----?---?XB--------E--X-M--------------------------E---M--B-----------------v
---------E-E--------o----Xo------B-?---o-E-------o------Eo?------M--------BB------o--?---------------------------X--------B------X-----o--B-?--------------B-E--E-o----------------BB-------B---X------f
-----M----------o--------------------?---X?---E-------B--------o-------------------------X-M-----X---------------M------o--M---BM---------B-ME--------E---XXo---X-o---------?------o--E---E--B-E------Mf
------------------o--------E-------------XM---?----------------------------------E-----E-----B-----------X------------------B--E-------X------------M--------B----o------------------------X-------EE--f
----?------------B-----M--X-------------------------?o--------o-----X---X-----X----X--X-X----oE----?-----------M----E----E-------?-----------------o-----------------------?------X---------X----o-o---f
---E-------?--------E------------o---------o----o?---------o------X--o--------oo--------M-------------------X-?----B-------------X------M----M---------o--X-M---------o-B-------------X----------M---MBf
--o----?----------?----?--?X----?--------M-------B-?--E---X---E-----X----------B----E------E------E----------B?-o--------------------E------------o--MEMM-o------------------?-X----B----X--E----M-----f
mB|----MX-------------o---X------|-----M--o----|---------------------------|---------?------B|----M-E----?--------------------------M----B------|-----------?------|-----o--M|-o----------|-?--------|-X
XXXXXXXXXXXXXXXXMXEo-X-XXXXXXXXXXXXXXXMMoXXXXMXXXBXXXXXBXXXBXXXXXXoMXXXX-XXXXBXXXXXXXXXXXXXXXXX-XXXXXXXXXXXXXXXXXXXEXXXXXXXXXXXX-Xo?XXXXXoXXXXXXooXXMXXXXXXXXXXEEXXXoXX?-XXXEXBXXXX-XXXXoXXXXXXXXXXXXE?X
