-------------------------------?------?--------E-----------------------------------------?-----------------o---------?------------------------o---------------------------------------------------------
------------?-------E?---------------------------E------E------------------------------------------------------o----------------------------------------------------------------------------------------
----------o--------------------------------o---?----------------------------------------------------o---------------o----------------?------------------------------------------------------------------
----------------------------------------------------------------------------------------------------------------------E-----?----------------------------------------------?----------------?--------E--
-------------------------?---------o-------------------------E----------?-----------------------------------------------------------------------------------------------------------------?-------------
----------?--------------------------------?---------?----o------------------------------------------------------------?---------------------------------?-E--------?-----------------------------------
--------------------------------------------------?-----E----------?------------------------?-----o----------------------?-------------------------?-----??-------E-------------------------------------
-------------------------------------------------?----E----?-------?---------?---------------?----E---------------------------------------?---------??-------------------o--------------------E--------v
-----?-------------------------------------------------------------------E------------?-------?-------------?----o----------------------------------------------------?--------------------------o-----f
---------------?------------------------------------------------------?---------------------------------?o-------------?------o-------------------------------------------?----------------------------f
-------------------------o?-------------?--------o------------------------o----------------------E------------?-------------------------------------------?------------------E-------------------------f
-----------------?-----------------------------------------------------------------------------------E---------------------------------------------------------?---------------------------------------f
------?------------?---oo-------------?----o--------------------------------E-----------?---------------------------------------------------------------------?------------------E-----o-?-------------f
-----------------------E------o----o-----------------E--o--------------------------------?-------------------------------E-----E-----------------------------------------------------?-----------------f
m-------------E--------------X-------------|-----------|-----------o------|------X--------------------------|-----------------|X--?-------o-o--------------X------------------------o------------X--|--X
XXXXXXXXXXXXXXXXXXXXXXXXXXXXXXXXXXXXXXXXXXXXXXXXXXXXXXXXXXXXXXXXXXXXXXXXXXXXXXXXXXXXXXXXXXXXXXXXXXXXXXXXXXXXXXXXXXXXXXXXXXXXXXXXXXXXXXXXXXXXXXXXXXXXXXXXXXXXXXXXXXXXXXXXXXXXXXXXXXXXXXXXXXXXXXXXXXXXXXXX
