--------------------------------------------------------------------------------------------------------------------------------------------------------------------------------------------------------
-------------M-----EB----------?------------------------o-------------------------------E------------?----------------o-------------------------------------E------o-M--------------EB------------------
-----------E---o----------------?----------------?----------------------------M---------------------------------------------E--M--E------B-----?-M------------oo---------?-----o-----------Mo-----------
--?-----------------?----------------M-B----------o-----?-------------------------------------E-------------------------B------------------------------------o------------------------------------------
-------o-------------o-------M--o--------o-----------------------------B-E----------------------Bo---?------------------------------------------B---------------?o------oB------------------------------
-----------------o?------------?--------?------------------o-------o--------------------------?-----------------?------E------?----------o----BM---E?--------------------------B---------B-?B-----------
-M-----------------------------------------------------------------E-------------?-----------------------M----------------M--E---?--o---------o------?--------------------------------------------------
-------------------B---------------------------?-----------E-MB-----E--?---M------Mo---------------------------------E----------------------------------------B------------------------------E---------v
-------------------o---M-------?----------E-------o---M-----------------M---------E-----------?E-------------------B--------BB-------E--------?-----o---?----------------------------------------------f
-E-o--------E-?--------M---?--E-?ME-------B---M----o---------o--E----o-------M-M---?-o--EX-----------?---o---?-----?-o-M-------B----?----?---B--?---------o-E--?-E-oo--o-----------?o--?---------------f
------M-B----oM-o------BEBM----M-------------B-B-------------?oB--o?--BM------?XMBM---o?BX--MM--B--?----E--B--E-------oo---EB----E--E------B---------B-----------?--E--E?-BM--?-?-----B-M-?XB?---------f
---BM-B---------------MB--E----o--oB----MBo-----?-o------o---EMEBB-------E------X-M---M-X----MEB---Bo----E-E-BM-----BM----------MBoB----B-X---B-?-----------EB---------XX-----------------X------------f
--E--E-BX-X-----EE----B----X-M----------E----M--oM--?------------?----?---EM--?XXM-|--M-oXE-----T---BEM-------E----XX---M-----o---E----B-XMooBB------M-----------??----X-T--------T-o-E-?----M---------f
-?-T--TT-X-Eo--E-T---o--EMX-T----o-T-ETM-MT--TT-o-MoTE----oM---XM-M-B-T-T--MBEX-X-T|-----X?-E-ToT--X--EToT--?----E--oB?TTT----TMTT--TTTE-To-ooX----TX-TT---E--o-?--?-T-X-T-B--o---|----X-B-X-X---------f
mB-|--B|-X-BB-|--|-|---|-B--||----o|--|------||-X---|-XX-X--|---XX---X|-|-X-X--X--||----XX--X||-|-X---X|-|---XX----B--X|||--|-----|-||---|-XX-X----|X-|--------------|-XX|--XX----|----XM--X-X---------X
XXXXXXXXXXXXXXXXXXXXXXXXXXXXXXXXXXXXXXXXXXXXXXXXXXXXXXXXXXXXXXXXXXXXXXXXXXXXXXXXXXXXXXXXXXXXXXXXXXXXXXXXXXXXXXXXXXXXXXXXXXXXXXXXXXXXXXXXXXXXXXXXXXXXXXXXXXXXXXXXXXXXXXXXXXXXXXXXXXXXXXXXXXXXXXXXXXXXXXXX
