--------------------------------------------------------------------------------------------------------------------------------------------------------------------------------------------------------
--------------------------------------------------------------------------------------------------------------------------------------------------------------------------------------------------------
--------------------------------------------------------------------------------------------------------------------------------------------------------------------------------------------------------
--------------------------------------------------------------------------------------------------------------------------------------------------------------------------------------------------------
--------------------------------------------------------------------------------------------------------------------------------------------------------------------------------------------------------
--------------------------------------------------------------------------------------------------------------------------------------------------------------------------------------------------------
--------------------------------------------------------------------------------------------------------------------------------------------------------------------------------------------------------
-------------------------------------------------------------------------------------------------------------------------------------------------------------------------------------------------------v
--------------------------------------------------------------------------------------------------------------------------------------------------------------------------------------------------------
-o-XX--------oo-----o---?-------------?-?----X---Xo-E--oX-X----E---------------XEXX---?----?E---E-o-?--EX-----------?-o?XX--E?-X-?-----?--E-----------E-?-o-oX-X---oXXo--?--------o--?X-----------------
---XE---??-------?-?--o?----?--E---o----o-o-EXX-X-X-X--?EXE?-------o-----------XXX-----?------E-----XX-X--E-------oE-----XX--?XX?E----?---E------E-----o?---?-XXX---XE---?E-?-------XX?-X?-------?------
-?XX---X--------------------E-------??--o---XXX-XX-X---XX-XE--?---?E----------?oX-----?---?---E-----XEX?X-??---o???--o-EEX-----XX-??---X------E-X-----------E-?X----oXE-?-E---------X-X-X----E-?---EE---
--X?---Xo-?-XE--EoX---E??----?--E----------o-X--?XX-Eoo?X--X------------EE----?X-----?---E-?--?------XXX--?-o-X--E--Xo--?X-o--?-X-----X-o-----o--X-?-----X?--XX-X-??EX-----?---------X-X--?-----EXX-----
--X--T-oXXX-X-T?-X-----------XXXX--oXE------XXXTXX-o?-X-X-X?-?--?-?---E?--X??X-XXET--E--?-----?--TX-o-X-X----X------X?-X-Xo-E--XT?X-X?X-------XX-X------T-XXEX--|X-X-XX?X----o-?-?-o-?XX--T-E-----X-----
m?X-?|E-XX-?-X|EoXXX-o-E---EE|X-X?-X?---?-?X?-X|oXX-|X-?-X-XXo??--?-X??XXX-XX---X-|--|-X---|?--oE|-XEXE-XX-XX--??o-??XX-X-o-?--X|X---XE?X--E---XXX-XXXX?|-|XX--E|X--X-XXX---E-?-X-|-?XXXo-|-|----X?-?X--
XXXXXXXXXXXXXXXXXXXXXXXXXXXXXXXXXXXXXXXXXXXXXXXXXXXXXXXXXXXXXXXXXXXXXXXXXXXXXXXXXXXXXXXXXXXXXXXXXXXXXXXXXXXXXXXXXXXXXXXXXXXXXXXXXXXXXXXXXXXXXXXXXXXXXXXXXXXXXXXXXXXXXXXXXXXXXXXXXXXXXXXXXXXXXXXXXXXXXXXX
