----------------E---------------------E----o-------?----------------------------?--------------------------?-----------------?----?------------------------------o-------o------------------------------
----------E-----------E---?--------------------------?-E------------------o--------------------------?-E-?--------E---E---------------------------------------------------?-------?---------------------
---------E--------o-----------------?--------------------------------------------?-----?E---------------------------------?-?o--o-------------------------?------------------------------o--------------
---o--------E----------oo---------------o---?--------------------E------?----?------------------------------o-?--E-----------------------E------------------------------o---?------?-?--------E---------
-------------------------------------------------?-------------o--------------------------?-------?------o-------------------?----------------------?---o----------?--?-------------------------------E-
----?--o--o----?------------------------oo------------------o-?------------?-------------------------------??-----------------E--------??o---?------------------E---------------------------------------
----------?---?-----------?-------------------------------------?-?---------?-o?-----?--?-----------------------?--?----?-----------------E--------o-----?---------------?o------?----E--?----E---------
-----E-------------------------------------o---?---------?----?-----??-?--------?--------------------?---------------------------------------o-?-----------------?---------E--------------------o---E--v
----------oo------------o--------o?-E------------------------------------?----?----------------------o?---------E---------------?-----o------o-----------?E--------------------------------------------f
--------------------?------------o----------o-?--o-------?-----?----------E--?---------?-?------?--?--o-------------------------------------------------------------------E--------o--?---------o------f
---------E--------E--------?---------o--?-------?-E----EE------------E-o----------------------?-----------------------o--E---E---------------o--------?----E-E--?---------------?------------------E---f
------------?----------------------o-------------E-------E----------------------?o-------------?-----------------o-----------------?----------E-------?-----------o-?------------------------o---------f
-------?-?----?------------?-------------------------?---------------------------E--------------E-E--o-----------------------------oo-----o-?E-----o------?------------|---------?-----------E-----??--f
--|-----E------T--------------E---E--o---o--------------------------------------------------------------------------------------------?--------o--------???---?--------|----?--------------------o-|---f
m-|--?-E-------|--?|?-------|-------|--|-------|-|--E-----------------o|------?||------|--------||-||----|-------||---|-|----------|o-------------|----E------|||---E|-|-----|--|-|?---|---|-|-|-|-|o--X
XXXXXXXXXXXXXXXXXXXXXXXXXXXXXXXXXXXXXXXXXXXXXXXXXXXXXXXXXXXXXXXXXXXXXXXXXXXXXXXXXXXXXXXXXXXXXXXXXXXXXXXXXXXXXXXXXXXXXXXXXXXXXXXXXXXXXXXXXXXXXXXXXXXXXXXXXXXXXXXXXXXXXXXXXXXXXXXXXXXXXXXXXXXXXXXXXXXXXXXX
