--------------------------------------------------------------------------------------------------------------------------------------------------------------------------------------------------------
--------------------------------------------------------------------------------------------------------------------------------------------------------------------------------------------------------
--------------------------------------------------------------------------------------------------------------------------------------------------------------------------------------------------------
--------------------------------------------------------------------------------------------------------------------------------------------------------------------------------------------------------
--------------------------------------------------------------------------------------------------------------------------------------------------------------------------------------------------------
--------------------------------------------------------------------------------------------------------------------------------------------------------------------------------------------------------
--------------------------------------------------------------------------------------------------------------------------------------------------------------------------------------------------------
-------------------------------------------------------------------------------------------------------------------------------------------------------------------------------------------------------v
-----?---?-----?--E----E?E---?-----??--E?-?-----?---o----?----?--o----?--E--E-?--?---?-------?--o----?--?--o---?-?---o--?--------?EE?-----?-?o------?-------Eo---------------??-?------?--oE-?o---oo----
-------o--------?--o-??--------------oE---oE----------------E---?----------o-----o--o-?----------o--o------------------E---o----?-------------?----------------?----o-E----EE--E---o?-?----o------??----
-----?E------E--o-------o--------o-------------o-?--Eo-?--E-??-------o--------------------??-----?-----E-----------o--o-----------------E--------?---?---o---?-?-E-----E-------oo--?------------E-E-----
---?-----?-?--------------------------o---E----??-o--E-----------E--?------?---o-----------------o--o--?--??---E--???------o-E-E----o?-??E----?-o----?-??--------------o-?---EE---------E?---?--??------
-?-----E?-?-----?---EE--------E-?E-----o--oo--?----?-----o--o--o-?-------?---------??--?------------o--E---?---oo-----?-----------?---?----E-?---E-------?-------------?--o------E----??--?-o?----------
--?---E------?----o--o---o---------E-----------E--E---E---o--?------o----------E-----------Eo--o---o----?-------------------------o-?-------o?----?-----??--------?---?-----o------?---------?--?-------
m-X|-X----|XX|----oX--oX---?XXXX|XX-?-X?---?X---|-XX-X-|XX?-XX--XX-|-X|-XX|?----?|--X-X---E?X--|-XX?|E|X--EX?E-XX-X----X-X------|-?XX-X|-|XX-X|XoE--EX--|--X|?-XoX--X--o-?X--|?XX--X-XX?X--?EXX--X--X---
XXXXXXXXXXXXXXXXXXXXXXXXXXXXXXXXXXXXXXXXXXXXXXXXXXXXXXXXXXXXXXXXXXXXXXXXXXXXXXXXXXXXXXXXXXXXXXXXXXXXXXXXXXXXXXXXXXXXXXXXXXXXXXXXXXXXXXXXXXXXXXXXXXXXXXXXXXXXXXXXXXXXXXXXXXXXXXXXXXXXXXXXXXXXXXXXXXXXXXXX
