--------------------------------------------------------------------------------------------------------------------------------------------------------------------------------------------------------
--------------------------------------------------------------------------------------------------------------------------------------------------------------------------------------------------------
--------------------------------------------------------------------------------------------------------------------------------------------------------------------------------------------------------
--------------------------------------------------------------------------------------------------------------------------------------------------------------------------------------------------------
--------------------------------------------------------------------------------------------------------------------------------------------------------------------------------------------------------
--------------------------------------------------------------------------------------------------------------------------------------------------------------------------------------------------------
--------------------------------------------------------------------------------------------------------------------------------------------------------------------------------------------------------
-------------------------------------------------------------------------------------------------------------------------------------------------------------------------------------------------------v
-?-??---?---------?----o------?---?-----?-------?---o------------?o?----?----------?E-----E---?----?---o----o---E--?-----?---E?------?-----?--o--?-?---?----?------??-----------E-----?------?----------
----------o--E---------o----------o?-?--o-----------o-------o----E--o---E--?-----E-o-o------------------E--------------E------o------?--E---E------E----------------oE----?E?------------------------E?-
-?------E---o?----------?----E--Eo-----?------?-----?---------------E-----------?--E-E------------------o----E------------E-------o?---?Eo-----?-----------------E------------E-----o-?---?E-?-----E--?-
-----?--o------?---E------------------o---?----------ooE-??E-E-?---?E------------?o-----?----o----o-?-E---E---E-?-?-----E?--E------------------?-o-??E----o------------o--o---E----o-----?-----?--------
---?--oE--?---E----E-E---?----------E----E-?-o--?---?---?Eo-?-??--?-------??-------------oo-------?-?-o?--?o------?-E?---oEo?o-?-?---?-?----E--------------------E-----------o---E------EE?-------------
----E-------o-E-------?--?E--?o-------o--?----E------E-?-------o-----?-----------E--E-------o---------o----?----o?-E-----?---o---E?---E-------o-E----E------------?--?--------Eo----E?--------E--?-E--?-
m?o--||?-XXX-XX?--X-Xo---XXXoEoXE--X-X?|X?|-X?--Eo--?o-|-XoE|E|XX-X---?|X--X-X-ooX---XE?XX?X?-X-XoX|---|X---XXX|--XXXo-E|X-X|X-XX|??-XXX?EXXXX?---|?XXXX-XX|XXX-X-?--?-E|o-X--|X-|-X|?XXXXE|X?X--XXX-X--
XXXXXXXXXXXXXXXXXXXXXXXXXXXXXXXXXXXXXXXXXXXXXXXXXXXXXXXXXXXXXXXXXXXXXXXXXXXXXXXXXXXXXXXXXXXXXXXXXXXXXXXXXXXXXXXXXXXXXXXXXXXXXXXXXXXXXXXXXXXXXXXXXXXXXXXXXXXXXXXXXXXXXXXXXXXXXXXXXXXXXXXXXXXXXXXXXXXXXXXX
