--------------------------------------------------------------------------------------------------------------------------------------------------------------------------------------------------------
--------------------------------------------------------------------------------------------------------------------------------------------------------------------------------------------------------
--------------------------------------------------------------------------------------------------------------------------------------------------------------------------------------------------------
--------------------------------------------------------------------------------------------------------------------------------------------------------------------------------------------------------
--------------------------------------------------------------------------------------------------------------------------------------------------------------------------------------------------------
--------------------------------------------------------------------------------------------------------------------------------------------------------------------------------------------------------
--------------------------------------------------------------------------------------------------------------------------------------------------------------------------------------------------------
-------------------------------------------------------------------------------------------------------------------------------------------------------------------------------------------------------v
--------------------------------------------------------------------------------------------------------------------------------------------------------------------------------------------------------
-E-?-?---E---X---?---Xo?-X--??----X-X---E-?--o--E---o-?-?-?-------E----?-E?----o--o-?E----o--------??-?-----?E---?----E-?XE-o-X----------E----X---?E-X--XX---?-?---X-oo--X--X-?----X-?---E--------------
----?-E---E-oXX-----??X?-EXX-?---XXXX-?-?-o-------o-oo--------------??----E---o----?-E----------o--E------?o?--E-?---??-??X--X--?---?----?X?--X-----??XXX?-------EX---Xo-?XXX--?---X---o?-?-------?--o--
-----?E----X-X-------X?--?X-oE-?--XXX----------E----oX-E---E----?----o-?-------X--?--------?---------??--E-X?-o---?---o?--X--?X-------???-EX-X-E-oX----X?-EEX----X-X-X?---XX----?-oX--E---o-------------
-------?-?EXX-?----XXo-XX?X-------?Xo-E-----?-?--T??-X-?o---E?-E---E----o----?--X-------o----o-------?-o-?-X--?-------?-XX-Eo-X-?------X--E-Xo-oXXX-X--oXXXX--?---XXXoEX---XX-o----X----------?X--?--?--
-TXXT-T----EXXE--?--Xo?-X-X?-?----X--E-o????--o-E|??--XEX-X?-T--?-oo--T-----T?--X--XX?-----?----E?-X-?-o----X-oo--oT?--XX-E-o--X-o--o-XXT-o-X--X-X-XEo--X-X|--T----X--X?--XE-X----?XE?----------X?-?E?--
m|XX|-|-----XXX----EXo---XXo-X-X-X-E-o-X|XE??--E-|--XX-EX-Xo-|-E?-?-X-|?---?||--XoXX-|----------|-X-XoX-X?XXXXXX?-?||o--X?--|XX-XE?E--XE|E-XX---X|XX|?X-XXo|--|?--X-XE-X?XXXX---?-ooX-???E-o-X-X--X?|?--
XXXXXXXXXXXXXXXXXXXXXXXXXXXXXXXXXXXXXXXXXXXXXXXXXXXXXXXXXXXXXXXXXXXXXXXXXXXXXXXXXXXXXXXXXXXXXXXXXXXXXXXXXXXXXXXXXXXXXXXXXXXXXXXXXXXXXXXXXXXXXXXXXXXXXXXXXXXXXXXXXXXXXXXXXXXXXXXXXXXXXXXXXXXXXXXXXXXXXXXX
