--------------------------------------------------------------------------------------------------------------------------------------------------------------------------------------------------------
--------------------------------------------------------------------------------------------------------------------------------------------------------------------------------------------------------
--------------------------------------------------------------------------------------------------------------------------------------------------------------------------------------------------------
--------------------------------------------------------------------------------------------------------------------------------------------------------------------------------------------------------
--------------------------------------------------------------------------------------------------------------------------------------------------------------------------------------------------------
--------------------------------------------------------------------------------------------------------------------------------------------------------------------------------------------------------
--------------------------------------------------------------------------------------------------------------------------------------------------------------------------------------------------------
-------------------------------------------------------------------------------------------------------------------------------------------------------------------------------------------------------v
--------------------------------------------------------------------------------------------------------------------------------------------------------------------------------------------------------
----E-X----BB----o--B-M-----E--EE-?--B---B--M---M-E--B--MXEo--o---E-----------o---?---------E---MEE--M--?--o---?---B------?---oM--EMB--M-----E---B-EB---B----?-B-B----B--B------o--Bo--o----MX----------
-E-----X--M-B---E-MB---?E-Mo-----M----B-------EB?--E-o----X-EM?MM?----Mo-?-----XMEE---B-?--o-oo-----B--E-------E?---B?---o--------E--------BB--E-M--o-o---E-o-E?-M-?-X-X?o----B--ME--------XX-----------
-----BXX---XXX-----B----------M?--------?--M-----o?-?-E--?X--X---------Booooo--X??BE-o----EE-----------M---Mo-XMX--?-B---oE--Eo----BM-MB-ME--M-M------MX-----o--o-?---X?-o?-----EE--?-------X-----------
-Eo---XXB-B-X--BB----?--------M---M----?X------M---M-?T----XX------E-----XXXo-X----Bo-----?---------M----B--E--XMT------oM---M--B-------o----oM--MX--XX---------M-??-X-E----?---M-TM--o-T---X-----------
---T-BX?---X--MT---BM---?-T--EBBo-T--EX-BX---TT-T--T--|T--E-X--XXEEoo--T?-XX-T-X-oM--EB-T--TX?---T?--M--TBT-T--X-|TT-o-MX-----B-T-TT-----T--E-X-oT-X?XX--BTT----B----oX---MM--T---|-TET-|-MX?T----------
m-X|-XX---XB-X-|----------|---X---|--BXX-X-X-||-|--|--||B--X---X--X----|---X-|--X---B-B-|-B|-X--X|-----X|-|-|-XXB|||B-XX-X------|-||-----|-B-X---|-XXX---X||-------BB-X-------|---|-|-|-|---X|----------
XXXXXXXXXXXXXXXXXXXXXXXXXXXXXXXXXXXXXXXXXXXXXXXXXXXXXXXXXXXXXXXXXXXXXXXXXXXXXXXXXXXXXXXXXXXXXXXXXXXXXXXXXXXXXXXXXXXXXXXXXXXXXXXXXXXXXXXXXXXXXXXXXXXXXXXXXXXXXXXXXXXXXXXXXXXXXXXXXXXXXXXXXXXXXXXXXXXXXXXX
