--------------------------------------------------------------------------------------------------------------------------------------------------------------------------------------------------------
--------------------------------------------------------------------------------------------------------------------------------------------------------------------------------------------------------
--------------------------------------------------------------------------------------------------------------------------------------------------------------------------------------------------------
--------------------------------------------------------------------------------------------------------------------------------------------------------------------------------------------------------
--------------------------------------------------------------------------------------------------------------------------------------------------------------------------------------------------------
--------------------------------------------------------------------------------------------------------------------------------------------------------------------------------------------------------
--------------------------------------------------------------------------------------------------------------------------------------------------------------------------------------------------------
-------------------------------------------------------------------------------------------------------------------------------------------------------------------------------------------------------v
-?-------------E--?o--?-----E----?--E-----?----------------?---?---------oE---??--?---E---?-------------?-------o----?----o---?---?---?--?--------Eo---E-------------?------------?------o-----o-----E?-
-------?------E-?----------?---?E-------?--?-----o--?--------------E-------?---o----?-E----------o----------?----?-?---E----o-----------?-o----o?-o-----o------o-?o----E?o--?--o---E--?-----oo?---------
-?----??--?---?-----?---?------?----E-----?---------------?--?----?E-----o-------E-?----------oE------o-E?-------?--o--------o?-?---?E--?----E---o-o---?E--E-------------o------?--?-----?-?--E---------
----E--o-------Eo-----------------o-----------o--o--o---------E-------E-?-----o--------o--?----?--?-o----??--------?--------------E-?-------------------------??-o-?---?-------?-----------o-?--?-?-----
------?------?----??--?----?--o------oE-------?------o--?--?----?--------o?oE-?-o-----o--?o---?E------?-------------E-E-E---o-------?E------?--------------------?o--------E---o-------?---??-?------?--
-------?---------?------?------?-----?------?-----------------------------o------------o--?----oE-------------E----?-----o-?---------------oo-----o-------------?-------?---------------?--------E-?----
m-|-X-|XooX----XX|o--XXo?-XE-XX--XXX--|-XX--?|X-oX-|--oX-X----X-Xoo-|----X----?XX-?X--X-X-X--EXo----X---oX?X?|X--X-?X-XE?XX|----?--EX---|X-|--X---|X-XX-XXoXXXXXXX-X-?X?X-X?-?--?-XE-X-Xo-|Xo-?XX----XX-
XXXXXXXXXXXXXXXXXXXXXXXXXXXXXXXXXXXXXXXXXXXXXXXXXXXXXXXXXXXXXXXXXXXXXXXXXXXXXXXXXXXXXXXXXXXXXXXXXXXXXXXXXXXXXXXXXXXXXXXXXXXXXXXXXXXXXXXXXXXXXXXXXXXXXXXXXXXXXXXXXXXXXXXXXXXXXXXXXXXXXXXXXXXXXXXXXXXXXXXX
