--------------------------------------------------------------------------------------------------------------------------------------------------------------------------------------------------------
--------?----------------------------------------------------B------------------------------------?B----o----------?------o--------------------------------------o----------------E---------------------
-----------------------o--------------------------------------------------------------------B--------------------------B----------------------------------------B---------------------------------------
---M---B-----------B---------o------------B---------------------------------------------------------------------E--------------------B--------E---B-----------------------------------M-------------B---
------------------------------------------------------------------------------?--?--E-B------E--------------B---------------------------------------------------------------M-------M-------------------
----------------------------M------------------B--B----------------------------------E-B----------------------B-----M--------------B---B----------E------------------?--E------------------EM--------o--
------------------E-?----------o--------------------------------------------E----------------------B--------------------------------------------------------?---------?------------------o--------------
---------------------M-------------------------------------------o--------M------------------------------------------------------M----------------------------------------------B------o---------------v
--------?-----------------X---------------------------?---------M-------------?--------M---------------------------------------------B------o---------------o----------------------------------------M--
---??------B-?E---o--o---BoXB?-E-E------?----MEXE-?--M-----------?-M-----M--EB-B---B------Mo-BoE---------BBX?o-----E--B-E-M--E--o-------X--B----EME-Mo--------M?------M--E-X-o----o------E----XX--------
----X--EE---------------M--XX--?--B---------?---X----EB---------------o------?---oB------E-B----X?--MoE?X-X----M--M-----B-----B-------EEX-?----E---X?---?M-----o----E----E-Xo--EB--B--?-o--M-M-X--?-?o--
--X----------o-----M--E---EX------EM-B----M---EX?-------M-----EM---------o-oE--EM----?B-M----X--X--B?----X?MEXB-X--o--?-------?-----?----X----X?--E?XME-----o-E----oB-------X-M-?-o----E-X-X---X--XM-o--
---?-o----E--?-B------Xo-XXE---------------E?-X---oBE--o---o-X--EB-----?----B--EM-B-------?M-X-?---M---E--XXM----X----M-o--------M--------X-B-X-XX-X---B?-E--------------Xo-E?-------Mo--XXB--oX--------
---Xo----?MB-o-Eo--o--BX--X-X-X-XB-E----------X-X-----XX--M--X-------BM-B--o?-X?B--o----MM--M-Xo-BB----Eo-X-X-XX-X-??--B----o---B-o-----E----oXMXMXB--X-?EoX-----B?-----MX--X----E?---M---X-MBoXX-------
m---X------MXXBX-?-X---X-E?|XM-XXoX-?--oEBoE-B-X--XX-EXBMX?-XB-----E--XBoXM|XX--M----BXX-X-X--?X-X---?---M-X?--XBX--?--M--MM--XX-o-------EX---MXXXX--BB|o--MXo?-----EX---XEX-X-??----X-?|M-X-XBX?M-BE?--
XXXXXXXXXXXXXXXXXXXXXXXXXXXXXXXXXXXXXXXXXXXXXXXXXXXXXXXXXXXXXXXXXXXXXXXXXXXXXXXXXXXXXXXXXXXXXXXXXXXXXXXXXXXXXXXXXXXXXXXXXXXXXXXXXXXXXXXXXXXXXXXXXXXXXXXXXXXXXXXXXXXXXXXXXXXXXXXXXXXXXXXXXXXXXXXXXXXXXXXX
