--------------------------------------------------------------------------------------------------------------------------------------------------------------------------------------------------------
----------o-E----M?--------------------------E?---M-----o-----------------M----------------------------?------E--o--o--o----?-----------------o-Eo--M--B------B-M-----------------E---?--?--------------
----B---?------?------o-------M-B--?-M--------------M------------------M-B--B------M------B------E----o-?--------o-----?o-M--M-----B-------------o----M-----------BM------------E---M--E-E---o----------
-?----o---E-----o---E---EM------E----o--M---o--ME-------------------o--------B--o-----BEE---B---------?---------------------?-M-?M--------B---M-o---B--E---------?-o---M-----o-o--M----?B---o-----------
-M--E?---------------BE-----------B------------E-B-oM?--M------B------B-----B--------E-------M----o-M-----------M-?-E-----B-----------E--B-----o-o-B------o--B--o--EB----M--o--B-?-?------E--B----------
-----BE-----M?---------E-?---EB---------?------------M?--------o-B---B-E--------------------?-o-?----------------------B------M-o--------E-------?---?--?----------o--B----E?--------M-o--?-------------
----------?MM-------------B------E-oMo-------------?---Eo-----------------M-----------MM----------E---E-----o---?-------EM---------E----E--E-------M----?-----E---------M-------E----M-------?----------
---------------E--o---B-----o-o---------Bo-------------E-M-o--B-----------------------E-M-?---E-------M---------------M-----B-----?--B--M---o----------MB------------B-----?--B-------------B----------v
-?-?-M-?--E----?-E----oE--o-o--E---------------M---E-------?---------M---------o--oBBM--EB---?--------M---?---------------B------?-----o------M-----------?-E-o------BE---------B----------------------f
---B----E-M--Mo----E---------M-----M---o--E---B-EM?-?----?--?--B-M-----o--------E-o---?Mo----B----?---M-------o--E---M----?-----------E----o?---E--?-E-EE--oXX--M---E----E----------oM-BE-B--E---------f
---?--Bo-M--?--B------o--------Mo--------------?o-----------X---oB-?---------E-??------------MM--ME------------?-?----?------M---o--??-B---E--B----M-E--?-----X---BB-------E--M-------|--?-o-----------f
-EEE-E-?-----------B-E----------|---E---?-o-E--------o---?o--X--X-|------M?-?----o---MB------B--B-o--M-B----M-oB-----|----------E---To-----------------?EEM---M-M-B-?-M--B------M-o--?|-E--------------f
-----MoM--?---------o-BEB-MTE---|---EB-|-----|--X-----B------XMX-X|--MB-----M-oE---|----E??T?---BEBB---M??|-ME---E---|------M-E---?-B--|---T---o-MT?-----------X-XB-----M----||-X-----|---TM-M---------f
----M--M|-TX----TTT--T|----|----|-|--XT|-|---|--|--?oMT----|--X-X-|-|--B-?oBT??--?-|--TMTTM|---|-TB-ToTEoM|----T?|-?T|?TToM---|-|---TT-|---TTTT?-E|----?-?|---|---XT-T|--o?-To|-oX--|-|---|------------f
m-?|--B-|-|-|---|||-E-|--X-||-|-|-|--XX|-|-|-|--?|-XX?|-|-B|-EX-|-|-|MX?|--|-|-|--X|oX|-||-|-MX|-|-o|-||-B|--|-E-|-X||-|||-B?||-|--X||-||-M||-||--|--|-|--|-|-|--M-|--|oX-|-|-|--X|o|-|-B-|oB|---------X
XXXXXXXXXXXXXXXXXXXXXXXXXXXXXXXXXXXXXXXXXXXXXXXXXXXXXXXXXXXXXXXXXXXXXXXXXXXXXXXXXXXXXXXXXXXXXXXXXXXXXXXXXXXXXXXXXXXXXXXXXXXXXXXXXXXXXXXXXXXXXXXXXXXXXXXXXXXXXXXXXXXXXXXXXXXXXXXXXXXXXXXXXXXXXXXXXXXXXXXX
