--------------------------------------------------------------------------------------------------------------------------------------------------------------------------------------------------------
--------------------------------------------------------------------------------------------------------------------------------------------------------------------------------------------------------
--------------------------------------------------------------------------------------------------------------------------------------------------------------------------------------------------------
--------------------------------------------------------------------------------------------------------------------------------------------------------------------------------------------------------
--------------------------------------------------------------------------------------------------------------------------------------------------------------------------------------------------------
--------------------------------------------------------------------------------------------------------------------------------------------------------------------------------------------------------
--------------------------------------------------------------------------------------------------------------------------------------------------------------------------------------------------------
-------------------------------------------------------------------------------------------------------------------------------------------------------------------------------------------------------v
--------------------------------------------------------------------------------------------------------------------------------------------------------------------------------------------------------
-??--------?--E----?---?-----o?XX-XXXE-o-E---XXX-?--?--X--XX--E?--?---E-------E-----X-EooXE-E--E-XX-----E--??X----??---?---oo-o--?-X--E-o?-E----?-o-----?-o-?--?-------XX----------o--?---o----XXX-X----
-?----------?-------X----------oX-oXX------o-?XE-----?-?X-X--?-----------------o-??-XXX-XX------XX-?-----XX?-X------------?-------ooX?-o----o?--?-----?------------E??--XX--?----------E----XXX-oXX--X--
-------------?------XXX---------oXXX?------XXX-?E-?-?-o--X--o--?-??-------o-?----X--oX-X-X?o----oX-------?XXX--E??-----------------XXX--E--o---?Eo----o----E-----?------XX?-EE-??----?-?-----X-?-XE-?X--
----?---?-Eo-X--?X-oXXX--------?X-XXo-------Xo?-------?--X-----?XEX-------XX---?-X??oX-EXX?X--?--X---o--X-X-X--EE-??----o-?---------Xo-?----T------?---?-?-------------o-X-o-E?----XXo--------X-XX--X---
-o--Xo----E-X---XX---XX--?-X?--ToX-TXEXX--XXX-?o?--T--T--Xo--?o--XXT--T--?XX--o-Xoo-X----XX---XXEX--E--X--XX?-?--o-XT--T-?---??-?-XX|-------|---??o-??-T-o-T-T-----T?-TEX---EX-o?--?XT?TT----TEXX----X--
m--?-XE--o?XX?--X?-|X?EX-?X?-o?|X-?|?X?X?ooX---|---||-|?XX--?-XX-?X|?-|XX-X-?--X|XEXX?--XXX|--X-|XXX?XX-oo?XX----|-X|--|E----|--|--X|-------|--E--|X|X?|-E-|-|-?--?|XE|-X??XXo-|-E-XX|-||--o?||XX-??Xo--
XXXXXXXXXXXXXXXXXXXXXXXXXXXXXXXXXXXXXXXXXXXXXXXXXXXXXXXXXXXXXXXXXXXXXXXXXXXXXXXXXXXXXXXXXXXXXXXXXXXXXXXXXXXXXXXXXXXXXXXXXXXXXXXXXXXXXXXXXXXXXXXXXXXXXXXXXXXXXXXXXXXXXXXXXXXXXXXXXXXXXXXXXXXXXXXXXXXXXXXX
