---------------------------------------------------------------------E---?------E--------------------------?-----------------------------------o----------?---------------------------------------------
--------------------------o-?----------E?--------------------------E----o-------------------------o------------------------------------------------?---------?------------------------------------------
--------------------------------E------------------------------------------------------------------------------?----------o--o--------?--------------------------------------?--E-----------------?-----
---------------E--------------------------------------------------------------------------------------?---------------------------------------------------?-o----------------------------E--------------
-------------------------------------------------------?-----------------------E----o-------------o------E-------------------------------------------?----?-----------------------------------o---------
-----?--------?------o--?---------------------------------------------------------------?----E--o-------------------------------------------------------------------------------------------------------
--------?-E------------------?-----------------------------------?-----------------------o---------------------?-------o---------o---------?----------?---------------------------?---------------------
-?---------------------------------------?------?---------------------------------------------------------------------------------------------------------------------------------------------------?--v
-------------------------------E-----o--------E-----------------------E----------------------------------------------------------------------------?--------------------------------?----------------o-f
-----?-------o-------------------------o-------------------------------------------------------------------------------?--?-----------------------------------------------------------------------?---?f
--------------------------------------------E----?-------------------E---------------------------------------------------------------------------------------------------------------------?-----------f
----------?--------------E-------------o-------------------------------------------------------E------E----------------?-----------------------------------------o------?------------------------------f
-------------------------------------o--------------o---------------------------?----------------------------------?-------?-------------------?---o--------------------------------------------------?f
---------------------------o---------?-----------------------------------------------------------------------------------?---------------o--------------?---o-----------------?---------------------E--f
m-----------------|---------------?-----||-------|------------------------------?-?--|------?--------------------------------------||------|-----------------------|----||-----------E|------|--?-|----X
XXXXXXXXXXXXXXXXXXXXXXXXXXXXXXXXXXXXXXXXXXXXXXXXXXXXXXXXXXXXXXXXXXXXXXXXXXXXXXXXXXXXXXXXXXXXXXXXXXXXXXXXXXXXXXXXXXXXXXXXXXXXXXXXXXXXXXXXXXXXXXXXXXXXXXXXXXXXXXXXXXXXXXXXXXXXXXXXXXXXXXXXXXXXXXXXXXXXXXXX
