--------------------------------------?------------------------E------------------o---------?---------------------------------?-----------------------------------o?----?-------------------------------
---------------------------------------------------------------------------------------o--------------E-------------------------------------------E-----------------------------------------------------
----------------------------------------------------------------------------------------o-o-------------------?----------o-----------------------o---?----?------------------------------------?--------
------------------?------?-----------E-------------------------?--?-----------------------------------------E------------------------------------------------------------------------o------------------
------E--------------------------o----?---?--------------o---------------------------?E-E--?----------------E?----?--------o--------?-------?------------?--------------------------?-------------------
-------------E-?--------?-----------------------o---------------------------------?-------------------o-------------------------------------------------o-----------------------------------------------
-----------------o-------------------?------------------------?-------------------------------------?------------------------------------------------------?----------------------------------------E---
---------------------------------------------------?-----------------------------------------------?--E------------?-------------------------------------?-?----------------------------E--------------v
---------------------------E---?-------?-----------------------------------------------------?---------------?-----?------------------------------------------------------------?----------------------f
-------------------------------E----------------------------?----------E--------?-----------------------------o-------o-E------------------------------------------------------------------------------f
------------?-------------------E--------?--------?-----E-------------------------------------------E--------------------------?------------------?----------------------?-----------------------------f
----------------------------------------?--------------------------------------------o-------------?----------------------o---------------------------E----?---------?--------------------------?------f
------------------------------?--------------------------------------?-----------------------------------------------------------------E--o-----o----------------o-------------------------o-----------f
----------------?--------------------E------------------------------------------------------------------------o-----------------------------o-------------------------o-----?--E-----------?-----------f
m-----------?----------X---------------------X-|------------E---------------?---|------------------X--------------------o---------E-------------X-------?--E----EX---------|--------------------|------X
XXXXXXXXXXXXXXXXXXXXXXXXXXXXXXXXXXXXXXXXXXXXXXXXXXXXXXXXXXXXXXXXXXXXXXXXXXXXXXXXXXXXXXXXXXXXXXXXXXXXXXXXXXXXXXXXXXXXXXXXXXXXXXXXXXXXXXXXXXXXXXXXXXXXXXXXXXXXXXXXXXXXXXXXXXXXXXXXXXXXXXXXXXXXXXXXXXXXXXXX
