-----o---------------------------------------------------------------------E--------?----------------o-----?---------E---------------------E------------?--?--E--E------------------?-------------------
---------------?---o-----------------------------------------------?--------------------?------------------------------------------?----o-----o----o----------------------?------E----------------------
----------------o--?-------------------------------o-----------------------------?-----------------------------------------------o-----------------E--?---E--------------?------------------------------
--------?----------------------------------?----------------------------------?------------------E-----?-----------?---------------------------------------?-------------?--------?--o------------------
--?------------------------EE------------------------E----E------------------------------------------------------?--?--------------E--------------------?----o--------------------------------------o---
----------------?-----------?-----------------------E-E------------------?-?------------?----------------E--E-------------------?--------------?----------E?-----?-----------------?--------E----o------
------------------E-----?---?---------?--------------------?----------------E----------o-------?--------------------E--------------------------------------------------------?--------------------------
-----o--------E----o-?--------------o----------------------------------------------------------------------------------------------o------------------o-------o----------------------------------?-----v
-?----E------E---o-?--o-----?--------EE-----o----?-------?---?E---o?--o-------?------------E-----?-E-----o---o---???--?---o-----?------------?-?------------E--E------?---o-----?--------?---o----------
----?---o-o----?-----?o--?E-----E-oo---E-?-E--o-----?o-?-----o-o--------?--------------------?------??---?--??-?---------------o----------------?--EEo?--?-E----E?--?-E---E--?-EE---o--------------o?---
--o---o----o-EE-o----Eo??--E---?--?-----?o---?--------oE------?-------?------o--------o---?-o-----o----?--o--?---?-----?------?-?o-o-?E-------------?----?---------------?o--o------E---?-----oE------?-
--???-------?-----E---E----------?----------------?---------?-?---E---?--------E------EE?--o?-o---o----?---?--o-?o-------------------o------??E----o?--E------------?-----?-----o---?o-------?------E---
--EE----?-----??--o?E---Eo---?-EE---o----?--------?-----??--------------E-----?-?-?--?------E----?------E--------o-------oE--o------------o--E-----------------?---?-------o?E----o--?--------E---?-----
----?EE-----------?----?E|-E-?----|-E-?---|-E?-|?--o---?ooE------E?-?T-o---?--------o|?-?---|---??o-?o-|----|-------?-----|----E-?|-|-?--T-----|---|||-o---E--T-|---??-|?-?---E----|-------?|---|--|-?E-
m|||||E-|?---|||o??-||??--|-|--?-|||o--|||||o?-|o---|o|?|-o||-|o|||o-||???||-E?--||??|||???||||E||-E|-||?-|||-?|?--o|-?-E-|---o-??||||--||?||-||E-||||-?-|?|o||-|-E?-|-|-|-|--??|?||-o--||-?||-|||-|----
XXXXXXXXXXXXXXXXXXXXXXXXXXXXXXXXXXXXXXXXXXXXXXXXXXXXXXXXXXXXXXXXXXXXXXXXXXXXXXXXXXXXXXXXXXXXXXXXXXXXXXXXXXXXXXXXXXXXXXXXXXXXXXXXXXXXXXXXXXXXXXXXXXXXXXXXXXXXXXXXXXXXXXXXXXXXXXXXXXXXXXXXXXXXXXXXXXXXXXXX
