--------------------------------------------------------------------------------------------------------------------------------------------------------------------------------------------------------
--------------------------------------------------------------------------------------------------------------------------------------------------------------------------------------------------------
--------------------------------------------------------------------------------------------------------------------------------------------------------------------------------------------------------
--------------------------------------------------------------------------------------------------------------------------------------------------------------------------------------------------------
--------------------------------------------------------------------------------------------------------------------------------------------------------------------------------------------------------
--------------------------------------------------------------------------------------------------------------------------------------------------------------------------------------------------------
--------------------------------------------------------------------------------------------------------------------------------------------------------------------------------------------------------
-------------------------------------------------------------------------------------------------------------------------------------------------------------------------------------------------------v
---o-??----o-o?-E-o?----?---?----------?--------?-?---------?------?--------?--?-----E-?------E----E?---E?-E-?--??---o--?--------?EE?-?-------?--E?o-----?-E-----?-oo----?--------?--?----E--------o-?--
-------E----E-----?-?--------?---o---o---oE----------o-----o------?------E------?---E------------------E----o----------E---o----?------?---------?-o------------------?-oE-------------??------o------E-
-----o----?-----?-------------EE------E-E-?o-?-------------?------------o----?o-o------------o--E---------o----?---o--o----------------?-o-o--?EEo?-E---E-E-----Eo----oE-----------E-o-o---------?-?----
-E---o---?o-??-----?------------?-----------o----o--?---------?--o-??-E-----o?-E--?-o-E--?E--o---??-o-------------???------o-E-E----o?----E--o--o--------E----??---E---E-----o---Eoo----------E----E----
---E-E--?-E--?---------------?--o-?--E----?------o-------?---------------?--------E----E-E---E--------?------EE-------?-----------?---------?-E--E-?----o-o-----?--E------o--?o--------o?-?-----?-------
---o?-------o---?-----------E---?-?--E---o-----?-----o?------E--------o----E?----------o--oo-----o----?--E------------------------o-?-----o--o-?--------------?-E?-?------------E-------?--E-?-?-----o--
m--X|X---X--X-X?---|X--X---E--E-X-X-|X|-E|XE-|oEXX-X-EX|--|EXo----|X-o|E-o-X--X-?----X-X|-----X?X-oE-E-X--XXX-?o--X----X-X------|-?XX----?XX|-XXEXXX-|-XX?X-?o-|XXX-X||---X|o-X-XEE--|-XXXEoX|??||X?X---
XXXXXXXXXXXXXXXXXXXXXXXXXXXXXXXXXXXXXXXXXXXXXXXXXXXXXXXXXXXXXXXXXXXXXXXXXXXXXXXXXXXXXXXXXXXXXXXXXXXXXXXXXXXXXXXXXXXXXXXXXXXXXXXXXXXXXXXXXXXXXXXXXXXXXXXXXXXXXXXXXXXXXXXXXXXXXXXXXXXXXXXXXXXXXXXXXXXXXXXX
