--------------------------------------------------------------------------------------------------------------------------------------------------------------------------------------------------------
--------------------------------------------------------------------------------------------------------------------------------------------------------------------------------------------------------
--------------------------------------------------------------------------------------------------------------------------------------------------------------------------------------------------------
--------------------------------------------------------------------------------------------------------------------------------------------------------------------------------------------------------
--------------------------------------------------------------------------------------------------------------------------------------------------------------------------------------------------------
--------------------------------------------------------------------------------------------------------------------------------------------------------------------------------------------------------
--------------------------------------------------------------------------------------------------------------------------------------------------------------------------------------------------------
-------------------------------------------------------------------------------------------------------------------------------------------------------------------------------------------------------v
--------------------------------------------------------------------------------------------------------------------------------------------------------------------------------------------------------
------X-o--E--?-o-?----?-----E-----?-?---??--??--o----o----o--XX-X?--oX---XXX--XXX-?--E--?-------?----o-?-?------------------?--------o--XXo-----?-??-XXX-?----------X--o---------X-Xo?X-?X--o------?X--
-?--??-X-------E?----??----?-E---E-E--XX-oE-?---?EE----??E--?-X--X----X??--XE---X-X?E---o--------------X-E---?--?-------E-?-E-----?o-----X--E-----o-o?EX--?o---o---oooX-----o-----XXX-X----X-X---?-XXX--
--?---X----oE---?---?---------?-------Xo-XX?-??--X--?----?-----X?X?--X-----X???--X-Xo----------o--?-EXX------XXX-----E------------?-?--?-X-X--oE--X?---X-X-----------EX-X---------XX--X-?---XXX?--XEXX--
-?-----X?---???-?---E---?---------?-??X-EX--E-E-X-E----?-?-----?XX---XXXX--?X-----XX--?----?-----o---Xo-------XXX-?--oo??-----?-?------?--Xo-?--XXX-----X--?o-?-?--X-X--X--?-??----XE--X-----X?X--X?XX--
-----o?-X---oXT-------?-o---T-Xoo--T---X-XX--XoX-??-?-?To-?-o---X?--X-?XX?XX-X-----X-XXTX-----??----XXXEo--o--TX?-XX?XXE-oT--o------?---XX--Eo-E-X-Xo-o--X---oEX---?XX---X--?X?---X-XXX----o--XX-?EXX?--
m-XX---X|---Xo|-??---?o-o--o|X--X--|--?-X|X-X||XXX--|X?|?--?-E|o-X-?-XXX-o?XXE-?-?o-XX?|?XXXE-Eo---?-XE---E--E|-XX--XX--?-|----o-?-----?-X-E-oo?XX-XX?o-EXX---X-X-oXXo?oo-XXXX---XXXoXX|?-?-XX-Xo-oXX---
XXXXXXXXXXXXXXXXXXXXXXXXXXXXXXXXXXXXXXXXXXXXXXXXXXXXXXXXXXXXXXXXXXXXXXXXXXXXXXXXXXXXXXXXXXXXXXXXXXXXXXXXXXXXXXXXXXXXXXXXXXXXXXXXXXXXXXXXXXXXXXXXXXXXXXXXXXXXXXXXXXXXXXXXXXXXXXXXXXXXXXXXXXXXXXXXXXXXXXXX
