--------------------------------------------------------------------------------------------------------------------------------------------------------------------------------------------------------
--------M--E--------------------------------------E----M------------------MM--------------------------------M----MB---B------------------?---------------------------------------------------------B----
-------B-------------------------------------------------------------?-----------E---------E------?----------------------M---oM--E-------------o-B----?-------------------------------------------------
-------------M----?----------------------------o------------------------------------------------------------M-----M-----------------------------------------------------------------------o-------------
-B-------B------?------?----------o------------B--------B---E------------------------------o--------------------E-----E-------------------------------------------------?-------------------------M-----
---------?-------------------------------------------B---------------?--------------------B---o---------------------------------------o--------------B--E--------------?---M---?------------------------
---------------------------------------------M------------B-M---------------------------------------------------------E-------------B------------------------------------M--E---------------------------
---------------------------------E--------------------E------------------B----M---------------------------------------------------------E---------?---------------o--------------------------------?---v
-----------M?-------------------------X--------o----M------------------------------BM-----------------o------X-------M-----------------B-----------------X-----------------------------?--------X-------
-----B?X-BXXXX-?----?-XXX-ooB---o-E?XXX--X-X-XX-X---BE--XX-X----oXXXo-------X-XXX-?-o-?B----E---X-XX---X--oXXXX-------X?XX---o--?--E----o-----E--X?X-X?o-XX?-------EX--??E----?---------oXX-XXXX----o---
----XXX?---XX------?E-EXoo-------Eo?X?--X-oXX?-X-???oo--XXX---X?XXXXX?---?--EXXX-XXX------------X-X?XEXX----EXE?X--E--EXX?-?E-------E---?---?-X-XXXXXoX-?XX------?-XX--B-??--X---o--?---oXE-X-XX--------
-E-E?X-XXXXX?-oo-----??XX--------o--X-oXXX-XX-X-XM-?X-?--XXX---X--BX---o-oX?--X---X------??------X-X?XX---------X-X-XX-X----?X----B?--?-E?---X-XXXX?XX?-oXX---??--EX-X----XX-XX?M-XXM--o-XoX?XX-----?E--
-o---XX--XX-XX-E?-----XX---?B--------X?X--XoX--XX--EXX-oXXX---E-X-X-?--?oXXXXX-?-E-XXX--EoX-------XE-oXX--Xo-?o--XXXXXXX---XEX?------E-?------XXX?XX-XXX----XX?-X-oEXX-B-o-XXXX-?X-X-----XX--X----X?X---
--E?--XE?X--XXXX?--oo-Xo-E--??-----E-XX-XXXXo-oX?----X-XXXX?---o-XX??XX?XX?-X?---XXXXE?X?X?------??EXoX---XX---M?X--X-XX---XX---XXXXXXX--?oE--XXXXXX-X??XXX-XMX?XX?-X-?-----XX--XMX-E?--E-X-XX-o-XXXXX--
mEXX-XXX--X----X?oXX??-XXE-EX?--?X-?-?XBX-X-E--XXXX-X-X-X-XX?EoX--X---X-X-XXX-X--XXo-X?XXX----?EE-XX-XBX-XX-E---XXXX-?X-X--XX--BX-XXMXX---XXo?X-X|oXX?X-XM?X?XX??XEoXXX-E-o-XX--?XX--?XX-X-o--XX-X-XX?--
XXXXXXXXXXXXXXXXXXXXXXXXXXXXXXXXXXXXXXXXXXXXXXXXXXXXXXXXXXXXXXXXXXXXXXXXXXXXXXXXXXXXXXXXXXXXXXXXXXXXXXXXXXXXXXXXXXXXXXXXXXXXXXXXXXXXXXXXXXXXXXXXXXXXXXXXXXXXXXXXXXXXXXXXXXXXXXXXXXXXXXXXXXXXXXXXXXXXXXXX
