--------------------------------------------------------------------------------------------------------------------------------------------------------------------------------------------------------
--------M-----------------M--o-----------------------------------------------------------------M----------------?----------?----------------------?------------------------------------------M----------
--------------------------------------?------------------------------------?----------------------------------------------------------------o----------------------------------------------------?------
----------------------------o----------------------o?----------------------------------------E------E--------------------E---------E----------------E---------------------------------------------------
----------------------------------E------E--------------------------?----o---------o------------?----------------------------------o--?-------------B--E-o-----------------------------------------o----
---------------------------------------------------------------------------------------------------------B-----E---------?--------o---------E------------------------------------o----?-----------M-----
---------?-BM------------------B-----------o--E-------------M-----------------------------------M-----------------------E-----?-----------------------?----?----------------------------------B---------
---------------------B------------------------------B--------?-----------------------------------?-B------------------------------------------------------E--------------------------------------------v
----------X-------------M---------------------------------?----------------------------------------------------------------------------------------------------M--------E-------------------------------
--------??-X-o-----------?--?--------B-----oX?-----o---?------------oo---o---------E------o----E-???-?------BEE-X?--X--XXXX-Eo-?--??--E-XX?---E---o-----E-----------?------?------?-M-----XXX-----XXXo--
--E-X-------XXX-?--?M-----X-----?-?--------XX-o---------E------?-------o---o----o--o?------E--?---E-o-------o-XX?--EXoX-XX-X--E--E--?----XXXE-M--o--B----------------------?-?----------X?XX---X---X----
----XX---X-X-X-----?---o---X?--------?-----EMM-?-oo-----??-?----oXX-o??----?---?-E-E-----X-BXXB---o-------XX-XEX-X---?XXoXX----E-------?--X--------------?------------B----X----E-------?XX-----XoX?oX--
---XX?---X?XX-?o-----------------?------E---MX--------?---?-?E?--?X---M?--E-T-?---------?EXX?X---o?X----E?EXX?E-XXXX-XX-XX----XXM-----X-oXXX-----E-X-----?--E---E-------o---X-E-?o----o-XXo-o?---XXXX-?-
---TX-?X-XX-oX-X---?-----?-----T---?----??-XX?ET-E-o--M--TT------X-----X???o|--To---------XX-?---o-oXXX---TXXXM--XX?o-XXXo?-?-XX?XX--XX-X?X--oT?-X-M-o-EX-T?--X-----E--T-X-E-B?-E---T-EXXX-oE?---?XEX?--
m-X|-||-XX--XXX?XXX?--?E-------||-o|o-E-X-X|XEX||??-?|--X||-E-----XE----XX--|-??-|--?-?--M-X---?---|XX--|-|?Xo--XX-|-?|X?--X|?-X??X-oX-XX-|-|-|oX?--XE-|oE|-?XE-Eo-X-?-|-XE--?o-|?E-|---XXX--X--oXE-X-M-
XXXXXXXXXXXXXXXXXXXXXXXXXXXXXXXXXXXXXXXXXXXXXXXXXXXXXXXXXXXXXXXXXXXXXXXXXXXXXXXXXXXXXXXXXXXXXXXXXXXXXXXXXXXXXXXXXXXXXXXXXXXXXXXXXXXXXXXXXXXXXXXXXXXXXXXXXXXXXXXXXXXXXXXXXXXXXXXXXXXXXXXXXXXXXXXXXXXXXXXX
