---E-E--------o-----------------------?-------?------------?---------------------o-------------?--------o------------------------o------?------------------------o--------------------------------------
--------o----------------------------------?-----------------------------------?----?------E--E----E--------------?---------?---------------?--------E?--o-------------o--------------------------------
---?------------E--o-----------------Eo------------------------o?--E--------?-----------?---o?-?-o---------------------?-----E-----?-?---------------------------------------------------o-------?------
---------------------------?-----o------?---------?---------------?-----------o--o-------------------------------------------------------o-----E-------?---E------?------?--E----------E------E---------
---------------?---------------?--?-----------?------?---o-----------?-E--------------------?-----o------------------------------------------E------?--?---------------E---?----------?--?-----o--------
-------------?------------------E---------------------------?o---------------?--o-----------------?------------o-----??--------E-------------?------------?------?-----------?-------E----E-------------
----o----E-----?----?----o?----------E----------?-?-----E----------------------------?----?------E-o----o----------?----------------?-------------E------------------------------?-?------------E-------
-----E---?-E-----------o---?-------------------------?---------------------------?------?-----?---?---------??-----?---E------------?--------------------------------------------------------?---------v
--------------------o------------o--?-------------??---------------------?---------------o---------------------?-------??------?---------o---?-------------?--E-E--?--------------------------------?--f
-----------------------------------------------------------------------------------------------o--------o----------?---------?-----------E------------------------E------------?------?-----o--?-------f
---?--?---------?----o--?-----o-----------?o------------------E-------o----------?------------------------?---?-------------------------------?-----------------------------?---------------?----------f
---------E---?---------------?--?----?--------------?-?---------------------------E---------------------------------------------------?----o-------------------------------------------------o-------?-f
------------------------------------------------------------------------------o-------------o-------?----E--------E---------------o--?----E---------------?---o--------------------E---------------??--f
-------E-------------??----?-----E---------------------T-?--?----?T-o--|---------?-----?--------------------?---o----------E--o----------Eo--T-E-----------o------------|--?------------E----|----?----f
m---E-|--|--?|-|-----|-----|---?|-------||-|---------|-||-|-------|-|--|--|----|---|----|o---||---|-|--|------?-|----|---?-----|||-||-|-?-|--|---|---o-------|---------E|----------E--?-|-||-||----||--X
XXXXXXXXXXXXXXXXXXXXXXXXXXXXXXXXXXXXXXXXXXXXXXXXXXXXXXXXXXXXXXXXXXXXXXXXXXXXXXXXXXXXXXXXXXXXXXXXXXXXXXXXXXXXXXXXXXXXXXXXXXXXXXXXXXXXXXXXXXXXXXXXXXXXXXXXXXXXXXXXXXXXXXXXXXXXXXXXXXXXXXXXXXXXXXXXXXXXXXXX
