--------------------------------------------------------------------------------------------------------------------------------------------------------------------------------------------------------
----------------E-------?----------------o-----------------------------------------------------------------B--?--------------------------------B----------------------?----------------E----M-----------
-----M-----------------?---M---------E-----------------M?----o-B--------?o-------------------------------------------------o-----B------------M---E---------M--B---------------o-----------?------------
---------------------------------------------------------------?----------------oB-------E----------------B------B?--------E------------------------------------------------------E----E----------------
----------------------------------?----B--?M--------------MM--------------------------?-----------B-----------o--------o-----------------E------------o---B-o----?-o-----------------------BE-----------
----------------------------M-----------E-B-E----------------o----------?--?-B-?--------E-----M------E------?B---?--------------------------?-----o----------------B---B------B?------------------------
----B--B--------------?B----------------------------?------------?---------B------------------E------B------M---------M----M---B-------------------------------Mo-------?-----o-------------------------
--------------------------------------?-----------------o-------M------E------o------------X----------?-M-o--------------------------------------------------------------------------------------------v
-----------------B--------------------------E---?--?--o------------------------------------X---X--o--------B-------------B-------------B---o---------------?--------------o-B----B-------E-------------f
----?------B?------E--EM----B-----E--B---?XoB---o--??--B--EM--M-----o?-B----o--B------M---EMXXX-??o---E------M----E------?--E------E-B?---------B--XXMo?XX-----o-MB------?----ME----------o------------f
----o-XX------------o-M-------o------------X-E-BMM-EE--BM-M-BEM----o?--?--oo-B------------?--B?---?M-?------M--o-?-o-------?-----B--M----BM-B--E---BXE-X?X---------?o--E-----------EB----M--?----------f
-------X----??-E--B--o-----?-B-?----------XX----EM---BT?E---?o---MB-------E--B----Bo---Moo-XE?-oX-X-X---B-------E?--BM-------M-o-?-?--oM-M---B-EM-----BX-----B---BE-B---------E-B-o----oB--------------f
-o-B--X---------o----X--BE-----ME---B-----XE--Mo-?M--o|B---XE--------X-E--TE---T--?MBE?--o--XMEMTX--B-B-M--o---BE---o--ME----E-------?--M-----B---E--XM--o-----o---oM-B--E---?-----?-?---XX--E---------f
--------|---?T--E---TX--X-T-oET-TT----oMT-X-E-TT------T-MTT--T-B---E-X-T--|-TM-T-TT-?--MB--XT--T|TXX---ooX--E-T-T--M-E----T-X|-----T-o--BTo-oB-T-----MXXT--XX?---X-TXX-T-TT--|-oT--T-X-?XX?--B---------f
m--X-BX-|------|----|-o|-X|oX---||----BX|--X--||--X---|-X||-X|-------XX---|-|--|-||---B--X-X|-X|||-X--X-X----X|-|---------|-X||------|--E|--X--|-X-|---X||--X|---MX|-X-|B|--X|--|--|-XX---X--|---------X
XXXXXXXXXXXXXXXXXXXXXXXXXXXXXXXXXXXXXXXXXXXXXXXXXXXXXXXXXXXXXXXXXXXXXXXXXXXXXXXXXXXXXXXXXXXXXXXXXXXXXXXXXXXXXXXXXXXXXXXXXXXXXXXXXXXXXXXXXXXXXXXXXXXXXXXXXXXXXXXXXXXXXXXXXXXXXXXXXXXXXXXXXXXXXXXXXXXXXXXX
