--------------------------------------------------------------------------------------------------------------------------------------------------------------------------------------------------------
-------------------------------------------------------------------------E-------?-B--------E---------------------------------------------M-------------------------------B-----------B-----------------
------------------------?-------------E----------------------------------------------------------------------------?-----------------o--------------------------------------M---------------------------
------------------------------------------------------------------------------------------?--B----M---M---------------?--------------E------------------------------------------------------------------
---------------o----?-E-------------------B----E------------------------------?--------o?--------------------------------------------------------------------------------B?-------B---------------------
---------------?------E----------------------------------------------X-----o-----------------------------------------M----M---------------B------------------M------------------------?-----------------
--------------------o------------------------X--------------------E--X----------------B-M--M-------------------------------------XX-------E-----?--------------------------------------E----------------
----------------B----?--------------------?---X-------------------?-X----------------------------B-----B------------------B-------X-------------------------------E--------------------B-------B-------v
---------------------o--X--------B------o------X-----------X--------X--------------------B---E--X-------------------------M------X-------------o-----------o----X--B------X--X----X--X-X-----X--X-------
----XX?X--X-XX-?-E----XXX-?o?-o-o-E?X-XX-X-X-?--X--EEE-oXX-X-Mo-oBXXXE-B----X-X-X-?-o-BEX---E--?XXE----Xo-----E-oXB---EX-X-o---XBX-XEE-o--XX-------oE-ooE-X?-X?X----o?X?--X?EXX--Xo---X-XXXXXE-EXX?XXX--
-B--XXX?---XX------?E-EXo-?------EoXXX--X-oXXo-X-B-?oX--EXX?---?XXXX??---?--EXXX-XXX--E-XX?-?-X-X-----o-X-o---XXXX-----XXX----XXX-E--X--EXXo--?----------XX--XX?-E?-XXX---X-XX-XXBo-?-XXX--X-?-oBoXXX?--
-E-E-XXXXX-X?Moo-----?-XX--------o--X-oXXXBX----X--XX-?--XXX?--X--XX---o--X---Xo--XX---XX---XXXXX---?----X-?--?MX------XXX?X?--XXX--XXXXXX--?o----------X-XX-X-?---M-X-?-XXXX-X?XX-X---X--X--??X--XX----
-o----X---XXXX-E?----XXX---?----?--?-X-XX---X--X---EXXXoXXE--?E-X-X-?--?oXXXXX-?-E-XEXXX-?----E?XX?-o??-o-E----XX---XX-X-XXoXX--XX---X-E----E-----------X-XXX????-?-XXX---XXXEX-XB?-X?-oEXXE--XX--oXoE--
--E?--X-XX--XXXX?--oo-Xo-E--??-----E-XX-XXXX--oX?----X-XXX??---o-XX??XX?XX?-X?o-MXXXXXX---XXX-o-XX--EXX-X?-XX??XE-?--XXXXXX-X?-EXXXo-X--X??X?----------X---XXX-X--oX-XX-E-Xo-oXoX-X-X--X-Xo--XX--EE-X---
mEXX-X--XXX-XX-X?oXX??-XX--oX?--?X-?-?XXX-X-E--XXXX-X---X-X-XEoXX-X---X-XXXXX-X--XXX-X---E?X----XX-XX-XX?-XX?-XX-E?-oXXXXX?oXEXXXX?-?-XXXXo-?oXX--?E-?X----MX?X--X-XE-XooEXXXEX-X|oE-X|MX--X-X-X-XXX-X--
XXXXXXXXXXXXXXXXXXXXXXXXXXXXXXXXXXXXXXXXXXXXXXXXXXXXXXXXXXXXXXXXXXXXXXXXXXXXXXXXXXXXXXXXXXXXXXXXXXXXXXXXXXXXXXXXXXXXXXXXXXXXXXXXXXXXXXXXXXXXXXXXXXXXXXXXXXXXXXXXXXXXXXXXXXXXXXXXXXXXXXXXXXXXXXXXXXXXXXXX
