----------------------------------------------------------------------------------------------------------------------------E-?------------------------------------?--------------?------------o--------
--------------------------------------------------?--------------------------------------------------------------------E------------------o-----------o-------------------------------------------------
--------------------------------------?-?---E-------------------------------------------------------------------------E----------------------------E-------------------?------E----------o-----------E--
---------E-----------------------------------------------------------------------o--------------------------------------------------?----------?---------------------E-------------------------------o--
----------------o-----------E---------------------------------------------------------------------------------------------------------------------------------------------------------------------------
-----------------------------------o-----?------------------------?---------------------------------------?-------------------------?-E------------------------------------?----------?--------?---?----
----------------?--------?---o---------o------------------E-?---------------------------?--------------------E----?------------------?---------------?--------------------------------------------------
-----------o-------------------------o--------------------------------------------------------------------------------?-?----------------o------------------------------------------?------------------v
------?----------------------------------------------------------o--------------------------------E----------------------------------------------------o----------------------------------------------?f
------o----------------?-----?---------------------?----?-------------------------------------E-----------------------------------------------------E---------------------------------?----------------f
---------------------------------?------------------------------?-------?-------------------------------------------------------E---o--------------?-------?-------------------------------------------f
-----------------------------------E--------------------------------------o------------------------?------------------------------------------------------------------------------?E-------------------f
------------------------------------?---?-------------------------------------------------------------?---------------------E-------------------------------?------------------------------------------f
-----------------------------------?---------------------------------------------------------------?-------------------E--?------------------------------------?---------------------------------------f
m--|-o--|-|------|-----------|------------|------?------------------------|-----------|---|-||------------|--------------||----------|-------|------|-|------------------------------------------------X
XXXXXXXXXXXXXXXXXXXXXXXXXXXXXXXXXXXXXXXXXXXXXXXXXXXXXXXXXXXXXXXXXXXXXXXXXXXXXXXXXXXXXXXXXXXXXXXXXXXXXXXXXXXXXXXXXXXXXXXXXXXXXXXXXXXXXXXXXXXXXXXXXXXXXXXXXXXXXXXXXXXXXXXXXXXXXXXXXXXXXXXXXXXXXXXXXXXXXXXX
