--------------------------------------------------------------------------------------------------------------------------------------------------------------------------------------------------------
------------M-----------------------------------------------------------o------------------------------B--M--?-------------------------------o----------------------------------------------------------
------o------------------------------------------------------------------------------B-------------------------E--------------o---B--B------o-----------------------------------------------------------
--------------------------------------------------------B----------oo---B----------------------------------M----------------------M--E-------oM------------E----------------B---------------------------
-?---------------------------------------------------------------------------------------------------------------------M-------------------------E---------------------o--------------------------------
--------------------------------------?----------------------------------------------------------------------o------------E---------------B---B-----?------B--------------------------------------------
-------B---------------?------------------------------------------------------------------?--o-------------------B-----------------------------------------------------------------?--------------------
------------------------------------E-----M-----------------------------------------------------------------M---?-----------?-------------------------------------------------------------------------ov
--?--------------X----------------------o-----------------------------------------------X-------------------------------------E-------------------------------------------------------------------------
---------X-X--o?-X---?o?-----?-------???-?XB---E----XE?-B-?E----?---------o---EE-X-X-??-Xo?-----oo--?-----o-o----X-?o-X-o--o---M--XX--------?---B-??-------XXX-------E---B---X---------?-E--o-?oo--EX-X-
--------E-X-o-----oX----?---o------o-XX--X---?------Xo--B--------E-----?-E?-E??o-oX?Xo---XE-ooEE---?-?------?-o---X?XX?------?--??X------------------o?E--??X-XE--?-----?o--E-X------??----o---?--E-?X--
---------oXX?-?-?X?XXX?o??---?-o----X-X--?X---?-?-E-X-----X----E----E--------?-X-XXXT--XX--oE-----o----EE-----EoEX?--XE----------XX?-------?XE--o?----------EXX?----oo----E--X-----?-B-----?-o-----X-XX-
---------X-XoE---XEXXE------------o--X---?-XXX-?-----XXX-X-?-o-To---T--o--------X-Xo|--X---?-?-----E?-o-o-X-E-----XX-XE---?-----X?XEE?----EEXX---------Xo?--EXoM-Xo--?-oo-E-XX------T?-?--??--o---EX?---
-E?---?o?oXXEo---XoXo?--o--?T----T?-XXT??---Xo-E---TEEX-EX---XX|-T-?|--?E-o-----XXX-|-EXX-XX----X-X-----M--X-T--o-XXX-T---T-?-TT-X?-o---?-TXX-T-T--E-?X-?-?--XXT--XXXX--o-------E---|-?-?-X-------TXX---
m-?oX-X?X--XX?BoX-Xo-|-X--X||X--o|--X|----X-X--E?--||X---XX-X-X|-|-E|-E-----X-E-EX-XX--oX-X----XXX-X-X|Xo-XXo|---E-X|-|-o-|---||o-?--X?-M-|-X-|-X--E-|XE|--?XX-|---X-|X-XMBX?X-E--?-|X--oX-o-o?o-B|X|---
XXXXXXXXXXXXXXXXXXXXXXXXXXXXXXXXXXXXXXXXXXXXXXXXXXXXXXXXXXXXXXXXXXXXXXXXXXXXXXXXXXXXXXXXXXXXXXXXXXXXXXXXXXXXXXXXXXXXXXXXXXXXXXXXXXXXXXXXXXXXXXXXXXXXXXXXXXXXXXXXXXXXXXXXXXXXXXXXXXXXXXXXXXXXXXXXXXXXXXXX
