--------------------------------------------------------------------------------------------------------------------------------------------------------------------------------------------------------
--------------------------------------------------------------------------------------------------------------------------------------------------------------------------------------------------------
--------------------------------------------------------------------------------------------------------------------------------------------------------------------------------------------------------
--------------------------------------------------------------------------------------------------------------------------------------------------------------------------------------------------------
--------------------------------------------------------------------------------------------------------------------------------------------------------------------------------------------------------
--------------------------------------------------------------------------------------------------------------------------------------------------------------------------------------------------------
--------------------------------------------------------------------------------------------------------------------------------------------------------------------------------------------------------
-------------------------------------------------------------------------------------------------------------------------------------------------------------------------------------------------------v
--------------------------------------------------------------------------------------------------------------------------------------------------------------------------------------------------------
----o?----o-?-EB----?---E-----o--?--o--B----B?B-M-o-X--------B-M--o--M-?---?--M-M-B----X---X-B-------M-?M-----o--B--B----E---BoE--Mo-o-M--E-?-M---o-----?--E----Eo-----?X---oB-?-M?---------E-----------
-oo--------B--oM--B-Mo--o-B-------M---?o-E--B-----B--X-o-o------B--B----MM---ME--B----EXBoB-X-M--------B--?-----M----o---oE---BM-?---B-B--MMB-B--B--?----XX--------------X-----?-M--o--B-XBEXE----------
-E-?------------oM----oo--?oB----?-E--o--M------o---X--o----M-M---B-o--BB---?--------EEX--E--XBX------Xo--BXX----B----------o-----M--oo?-----o-----Eo---oX-o----oB---M--E-X----E---------X-XM-----------
--?-Eo-o--o--------o-?M---B-X--o-E---M-------------oXX---------------?-M--o--?-?--M-B--XXX---BX?-EB---X-----XX--B-----B---E---M-B-----?BTE-------E-E---B--XoT---X-E----T-?-XM----?BEB-E---XX------------
---BTT-EXXB-T-----X-EX--T-oT-XXTT--T-?TTT-?-?T----BXX--B-?T?-o-T----XX-X-----BX-EoBTT---X-T-?M-X---MEX-B-o-TX-T-M-T-XB---TM?----T--TB-?-|T----MMX-T-T---TBXX|T--EX-T---|T?X------EX-B-B-X-Xo------------
m---||-XX---|----X--XB--|--|--X||--|-X|||----|----XX-----X|-XBX|----X--XX-----XXXX-||--X--|---X-X----X-----|-X|B-X|BX---B|--X--X|--|-X-X||--X---X-|-|---|BXX||----X|---||-X-----XXXXX--X---XX-----------
XXXXXXXXXXXXXXXXXXXXXXXXXXXXXXXXXXXXXXXXXXXXXXXXXXXXXXXXXXXXXXXXXXXXXXXXXXXXXXXXXXXXXXXXXXXXXXXXXXXXXXXXXXXXXXXXXXXXXXXXXXXXXXXXXXXXXXXXXXXXXXXXXXXXXXXXXXXXXXXXXXXXXXXXXXXXXXXXXXXXXXXXXXXXXXXXXXXXXXXX
