--B?---EXM-X-------------?o-E-B----o--------E-T-X-B-----??---|--|--Eo-EX-M|-o---|-X--?--|MT----o--oB-----?--E----T--E-|---?X?o--B--X-E--X-MB--B--------|--B---B---||-M---B-E|--B---X-?-|--BE------E-oB--
-M---o-----|----|MM--|X|-T--BoB--o-XE---|-M-|-TBM-|X-X--oB-T---X---|o---------E-|?o----M|--|-ETB-?E|-?X--TXo-----|--B?|B--M|---?---XM-B----o-X--|M---X--o---?MoE--B|?oM-----M-oMX--T-X|X-|-----M---BXM--
-|Mooo|BT---o-M----|-o-|B-----E-X--EM?-X--M?---T-T?--?----|--TE---?-o-|T--E----?--X-M-----T----?o---X------|X-M-X-------T--o--TE-----T-B-E---o-?o---------TEX---T-B-M----M|M-M---?o-M---------MMBoE-BE--
------TBo-----XMB-M-------XT--o----|--?--T----M--|-X-XBo-oM-------X?-B---B---B-E-B-----T-EB-----E|oXM--X|-?TX----oET-----TET-oB--|E----oTM-|-E?Boo?-|--T-M--|M--M---T-X--?-EE---B-----o-M----|---ME?----
-B------M-o-||X--o?-TX||-|-E-E-T|----B?--oM---MB-|X-XB-XM-T----E-?---BTo-M-B--B--EXo--T---M??TM---M-B-XE-T-?--?-?o--E---------XXXo-T|-B-M-|--o-T-----MB-T-E--o--E--o-|-X--E-?E-o--|M--M-TX----M-----B---
---M-M----M-E-|X---o?T----E--T-----?------XTTB---M-X-E--E|--MX-?---E----M----XEE---|-X--XE-T-X--?-M-E--oB-X?B?------X-EoEE--E--B----XE--|--M-M|--E|M-MX---?-|BME?----T?-|-----|-----?MTM--|----To-EX-TM-
-E------B?---o-o-|-E-o-ET-T-?TTM-?-BX-Mo-|-TEEE---?--?M--BE-E|-TM--T-oT--X-E---E-?-E--MEB-?XoTT-B-----X-----T----|o--T------o-|-T-M|T||---X-|-------M?----EX----oXBB?--o-|o--|BEE-M--M-EE-E?T--|---|M-o-
---|M---X---T-|-o|o---o---BE-o-TB-T|M-------oT------E-----?----E---XE-o-XMM-|-----|----X-X-M--?|MoB|X--T-EE|-M----XX----o--------?--E---?----TE?o-T---|XE-----M-|-MT-----TX---|?--|MM--------|-B-M-o---v
--o--|-Eo------M-----?-----?-E---T----BM-||-T-T?-o--?--T----?--o|-------EoXX--o--X--To--XX-MB--||-B--EE---|-|--BM?--?-|B-ETM---|---XoEBE---BMB?--M-MT-E?o-?E----oE-o|------E?---?oTo?BB---??B-XTB--T|--f
---T-T---E|-T-------X?---|B-------X--TX-TB--Mo--T--E--X-|-EE|-BX-ME-|--|-E-B---?-E-oB----B--B-o-MX-|E--------T-T|-----------MM?XE-oT-E-M---MX?E--?-E?|?E---X--E|--E----oB|--B?M----oo---o-------X--?-M-f
--T?-XoM--T-?oBoMTo-|E|-X----T---EB---?-EBT?-?---EB-M-XM-ME-----E-MX---MB--E?---|o--B?--XBT----T--|-|?---M-----EM-??-MM-X--?E-X--B--?--o---M---XB-E-|X---XT--|--XME?B---?-?-o--?-----X-|---o---T-B--?-|f
-E----E|-|o---E------T--o-B|BX-X-E-o-E|-o---B|E--oBBB-ETX--M-o----?BMM----TB----o--T---E-T---?o--XB|?-|-o----o--M|--oT-----X-XXT--T---?-XX-M|-T?-|----X--|M?-|o-MEB-|B--T----XM----oEo-------M?|-|-M-X-f
--BM-X---?--E|oT?-EBX--|oo-MMXTX-B-E---M-----o---T----M---EM--o-----M---TT--X|-----------EoX-BB|--M-B--T---B-o--?-M-X?o------||E-M?B-----BT----------B--XBE-E?|TETE|X?--B|B-BX-M-MT----BME---B----XXM|-f
--o?BE------o----Xo|o---E--M-B?-|MM--B-----M--T---M-TM-B-M--BE--?---B----T--|EX-M?-----o---|TTT?--BXM?T--?T---E|--o-XoE?M-TE----Bo----B-X-B--EX----M---MB?--|----Bo-M---?---|--B-X-TM-X|E--X-BB--------f
m---o----?---|B-?M?-MEBB-B----M----To?B--o---XB?-E--E-oT---|---E-M-X-E|---B-----TM-T?-----T-?XX-oXo?----?oE|---MT-M-ME---XX-|-T-B|-?E-?Bo-M?T----M----B|-?-TTT|||-M|---X-X-?B?-MXB---E?XMB----TMM-E---?X
XXXXXXXXXXXXXXXXXXXXXXXXXXXXXXXXXXXXXXXXXXXXXXXXXXXXXXXXXXXXXXXXXXXXXXXXXXXXXXXXXXXXXXXXXXXXXXXXXXXXXXXXXXXXXXXXXXXXXXXXXXXXXXXXXXXXXXXXXXXXXXXXXXXXXXXXXXXXXXXXXXXXXXXXXXXXXXXXXXXXXXXXXXXXXXXXXXXXXXXX
