--------------------------------------------------------------------------------------------------------------------------------------------------------------------------------------------------------
--------------------------------------------------------------------------------------------------------------------------------------------------------------------------------------------------------
--------------------------------------------------------------------------------------------------------------------------------------------------------------------------------------------------------
--------------------------------------------------------------------------------------------------------------------------------------------------------------------------------------------------------
--------------------------------------------------------------------------------------------------------------------------------------------------------------------------------------------------------
--------------------------------------------------------------------------------------------------------------------------------------------------------------------------------------------------------
--------------------------------------------------------------------------------------------------------------------------------------------------------------------------------------------------------
-------------------------------------------------------------------------------------------------------------------------------------------------------------------------------------------------------v
--------------------------------------------------------------------------------------------------------------------------------------------------------------------------------------------------------
-MB?-?EM-B---?o--oM--?-?------BM-X----B--E------oo----EM--B-?B----M-o-------E-E--MM-B--M--o--o---?--o---B-M--------o-----EM--?--B-----??-----??--B----?oE---??-E-B--------?------BB--EM-o---B?-B--------
---M----o---Eo-M-----M----B------Xo-E-------oB-----?---Bo-M-?---E------B--o----?-?B---E-M--------------EE--------M-?-----M-ME---B-----B----EXXM-------oM---oEB-MX---E--o---------X-------BE--?-M-o------
-B-----------o-------MB--?----M?Xo--?--?B-?E-?-?---B--------------B--M-BB-----E-B-?-o-E-----B-----E----M-M-------------EM----B-B--------?---?XM-o--M----M-B----XX---------o--B-?X----X----E-o?--o-M-----
-?---X-M------XE---?M--B-oM?----X?-------?--X--------B-MMM-o-----o------------o?------?-B--E-o?-oX-X-?M--BB-?E------EB----EE--M---------M-EMEXX?---B---o--E-----X--E--------M----XX-X--MB-oo---X--X-----
--M-X----BE----X--EXXo---B-MM---X---B----M-X------ME-----M?X---?o?M-----B---B-?B-o----M?X---MB-?--X--B----Mo----E-?------------E---M---X---X-XXX-E-?-M----------BX-X-o-o---M-E--E-XXXXo-E---o--?XX-?----
m-XEXXB-X-X-E---X-XX-B---B-o---X-XB-o-XXB--oX--B?-?BBM---XXM--BEo-X-XX-oXX----??-X-X-ooX---o--M--X-oB-M-EoBX-----o------M-E---MB?------XX--?XM?X---oo-X?-M-XMXX-X--XXM--B----X-Xo-XXX-M--B?--EB-X-BXo---
XXXXXXXXXXXXXXXXXXXXXXXXXXXXXXXXXXXXXXXXXXXXXXXXXXXXXXXXXXXXXXXXXXXXXXXXXXXXXXXXXXXXXXXXXXXXXXXXXXXXXXXXXXXXXXXXXXXXXXXXXXXXXXXXXXXXXXXXXXXXXXXXXXXXXXXXXXXXXXXXXXXXXXXXXXXXXXXXXXXXXXXXXXXXXXXXXXXXXXXX
