--------------------------------------------------------------------------------------------------------------------------------------------------------------------------------------------------------
-------------M-M---------------B--E-----------------o----------B---M-----------E-------M--------------E----M---------------------------------------------------------------E-------B--------------------
---------B--------------------o--------------------------o----------------------E----------------B-M--M-----------o-o-----M-------------------------E----------------------------M----------------------
--------o-------------------?---B-------------------------------o---M-----?E----?--------------------------------?-------------------------------?--------B-?------------------------B-----B------------
-------------------E-----B--?---------?---B-------------------------------?---BoM----E-------B--------------E---?-----------E--------B--------------?---------------------?----B------------o-----------
----M---------------------M------------------------------?--o-----------M---B------?------------------B--------------o--------E-------------------o---------B-----M------?-------E----------------------
------------------M--------------------E---------------------B----o-----------M--------------o---------------o-E-----?---------o----------B----------EB---------?-----------------?--------o------------
---------B-------------B------M---------E----?----B-----------------------o-----------------?----o---------B------?------------M---E---------------------------------------------------------?---------v
-------------?-------o----------?M------B----------------M----------------------B--------EB-------E-------E----E---------------------?-------------------o---o---------------E--------B----------------f
-------------o?-----o------M----M-B-E----?---MM?--M?----o------M-o--?------M?----X---o----B---o----?MM--BB--M---E?-E-----E----Bo---o--E--o--o---?Mo-E----o----?--B--------?-?-??---M----oEM?-----------f
------o-M--oB-o---M--M-o----MB-o--o----?-BE--?-Eo--E--M--o-M--------?-B---M----oMXB--X--?-----E----E-E-E-------Eo--M----------oo-----------E--?---o--X--?--?XB--M---?---MB------EE?---M-?-?--T---------f
-----o--?-----oB----?--B-MB----EM-------E-M----B---M--------o----M?---o----------X--X----M----XX-----oE-B-B----E-E-----E---o-B----------o--------B------B-M--X?--?----MB--?--??--B--o---?--E-|---------f
----o-----------T-----E--E---------?B--M---B-oM---M----EE-MM-----T-X--X----o---?--X-----------X---M----M--?-B?E--T-M-----BXE---M-o---B----M-o-B--------M-?MB?X-B--M---EM-BE---?-o-B-M-BEM---M|---------f
---o---TX---B-T-|---E-?T--ET-T-T-T-To-T-T---Xo-TTET-oo---------T-T--X---TT-ET----X-----T--E--oXX-TXB--T-T--X-----|T|-|-TT-XXT--XT--B----TBX--TT---TEE-MXM-MXX---TTT-?-?--BT--?--M|-----X-o?-o|---------f
mB|---X||-----MB|---E|E||--|-|-|M--|--|-|-X----||-|--B------X--|-|-X--|-||--|----X?XB--|----X-X--|-X--|-|---|----|||-|-|--Xo|-B--Xo|---X--X--||---|-X|-X--X|----||--------|------|------XX|-X|---------X
XXXXXXXXXXXXXXXXXXXXXXXXXXXXXXXXXXXXXXXXXXXXXXXXXXXXXXXXXXXXXXXXXXXXXXXXXXXXXXXXXXXXXXXXXXXXXXXXXXXXXXXXXXXXXXXXXXXXXXXXXXXXXXXXXXXXXXXXXXXXXXXXXXXXXXXXXXXXXXXXXXXXXXXXXXXXXXXXXXXXXXXXXXXXXXXXXXXXXXXX
