--------------------------------------------------------------------------------------------------------------------------------------------------------------------------------------------------------
--------------------------------------------------------------------------------------------------------------------------------------------------------------------------------------------------------
--------------------------------------------------------------------------------------------------------------------------------------------------------------------------------------------------------
--------------------------------------------------------------------------------------------------------------------------------------------------------------------------------------------------------
--------------------------------------------------------------------------------------------------------------------------------------------------------------------------------------------------------
--------------------------------------------------------------------------------------------------------------------------------------------------------------------------------------------------------
--------------------------------------------------------------------------------------------------------------------------------------------------------------------------------------------------------
-------------------------------------------------------------------------------------------------------------------------------------------------------------------------------------------------------v
--------------------------------------------------------------------------------------------------------------------------------------------------------------------------------------------------------
---E-BE--------MB-X-----?M---?--oE--?----o----MM---E------------B------oo?----E--E-------B------X---E--B----MB--------X--o-B--E---------X---M---E----------E-?-----?EBME---o--o----------?-oX-----------
--M-----o-E----o--?XX-----B-----M-B-MM--B---B-----o-EX-oo---E---B-------?---M------o---?----X-BX-Xo?B-------BB---------Xo--B-----?-----X----o-?-M-----------?--o-B--o?--o---o--------BM-?--X------------
----M------?---Eo--X---------------------E-----M-E---BXEB-----B---B--B-E-----o------E--M----XX--XX--B?-----X-MB-o---M--BX---E-M---M--XX------?X?-?B-----B-------?---B-B-------M-------------XX----------
-----------TE?---BoX----------M-----?-M-?---M-B-M--E---X--XB?-B---o-----?-T-----------------X---X-XXM--E----X-?----E--EXB---To-ME?---X------EE-X--M--M---??T?E?--B--Mo--M--?-Eo------o-----XBX----------
-T--TTT--?-|-XE-T-XTB-o-Bo--X-TBB---o---------T---T-----XXo-B-T--?X--B-T-T|--TB---T?-?--ooT?X-EX--oXX--?T-E-X--XT-B----TX---|T------ooX-ToT--?XX---XEXBoX--|-T-?--BE--E-o-TTMT-TTT--MM--o-E-XM----------
m|--|||--BB|--XB|BX|-B-X-X--XX|--------XX--X--|---|---B-XX----|-XX-----|-||--|----|-XXX---|-X-XXX--X----|-XBXXX-|-----B|-X--||--------BX|-|--X--X-XXXX---XB|B|-------B----||-|-|||-XXX-----X------------
XXXXXXXXXXXXXXXXXXXXXXXXXXXXXXXXXXXXXXXXXXXXXXXXXXXXXXXXXXXXXXXXXXXXXXXXXXXXXXXXXXXXXXXXXXXXXXXXXXXXXXXXXXXXXXXXXXXXXXXXXXXXXXXXXXXXXXXXXXXXXXXXXXXXXXXXXXXXXXXXXXXXXXXXXXXXXXXXXXXXXXXXXXXXXXXXXXXXXXXX
