--------------------------------------------------------------------------------------------------------------------------------------------------------------------------------------------------------
--------------------------------------------------------------------------------------------------------------------------------------------------------------------------------------------------------
--------------------------------------------------------------------------------------------------------------------------------------------------------------------------------------------------------
--------------------------------------------------------------------------------------------------------------------------------------------------------------------------------------------------------
--------------------------------------------------------------------------------------------------------------------------------------------------------------------------------------------------------
--------------------------------------------------------------------------------------------------------------------------------------------------------------------------------------------------------
--------------------------------------------------------------------------------------------------------------------------------------------------------------------------------------------------------
-------------------------------------------------------------------------------------------------------------------------------------------------------------------------------------------------------v
-?----E---E--?-o-Eoo---?-E-------E-?----------??----?---E-----??--o----E-?--?-?---??-?-----??--------E-?---?----?------E-------E------o?o?---o------o-E----E?-----------?E----o------???--?------E------
-?------------o----o------------?-?-----?-------Eo---------------E------?--?--o----------E--------o?----??E------o--------E------?-------E------?------o-E--E----o--------------E-----E-?-?o---o-?------
-----E----?----?--?---?--E-----------?---o-o-------??----?o--?-o---E-----------E-?--o-----------?E--E----------o-------?--------------?---------?--------E-------?o-E-o-?-----E-o?----?--E------o---E---
-----??-?o----------?--------?---E----------?---?-?------??---------o------o------------E---?------------E--?----?-----?-----?----?---o-?----E-----E--?o--?-E---?---E-----?E----?-------------Eo--?---E-
--o-?-----E?--o--o----------o------?------E----E--?----o-----???E-EE--?------------?------EE?E-?-?o-----------o--?--------?-E-??o-------?---?----------------?--o---??-o?---------o-----o-E-----?-E--?--
-------------o-?----o-----?-o-------------?----------------o----?-?--o------?------o----?-o-E------?--o--?--o---?------------o----E------------?---o---?----?-----?-----?-----?-------o---?----?--?-----
m--E-XoX---|-?|X-----XoXEX-X?X?o-X-X?-??-|--Eo|-X-X-|-X-|-XX----X|E?X?X--X-X-EEX-----XE--X|X-X-X-X---XX-?|o--|-XX--?--X-o-|-E?o-|-|ooXE---o------XX?-|-XX|X|X?XX?|o--o-?X-?--?|-|-XX---|XX--?oXX-?-X--|-
XXXXXXXXXXXXXXXXXXXXXXXXXXXXXXXXXXXXXXXXXXXXXXXXXXXXXXXXXXXXXXXXXXXXXXXXXXXXXXXXXXXXXXXXXXXXXXXXXXXXXXXXXXXXXXXXXXXXXXXXXXXXXXXXXXXXXXXXXXXXXXXXXXXXXXXXXXXXXXXXXXXXXXXXXXXXXXXXXXXXXXXXXXXXXXXXXXXXXXXX
