--------------------------------------------------------------------------------------------------------------------------------------------------------------------------------------------------------
------M------B---E----------------------------M--------------------------------?------------o---------------?----------------------------------------------------------------------E--------------------
---------E----o--------------------------------E------------------------------E----o----------------------------o--------------Bo-----------------------------------------------------------------------
------------------------------------------------------------------------------------o-----------------------------------------------------------------------------------------------M-------------------
--------------M-----?-------B---------------?--MB----E----------------------------B-----------------------?-------------------o----------------------------?--------------------------------------------
--------------------------------------B----------E-------B------B--------------------B-----------B----------------B---------------------------?-------M---------------------------------------o---------
------------------------------------------B------------------------------------B-------------------B---B--------M---------o------------B------------------E---------------------------------------------
---------------------?-------------------------B--------------------------------------E----------------E--------------------------------------------------B----------o----------------M---------B---?--v
---M--------o--------------------------------o-X----------------------?-X---B--------------------------X---------------M---------------------------o---?-------------------X---------BX-----------------
-------------X--XXXX?--XXX?--X-X------Xo?-XE-X?XXXX?-XXXE--?-?-?--E-E-XX-X-E-X-?-X-E-----X-?XX?--?XM-X-XX-----B-EX--X?XXoo-oXX?-----?-B---XX?---?XXXXXXX--oX--E--X-----?---?XXEXXX-?EEoX---X--??--------
--?-X-B-------X?X--XX-oXX--o-----X-??XE--o?X-XX?X-X-?-X-XX----E-?E--E??-XEX-XXo-X?-?-----X-X-XX-?X-Xo--X?X-XX--XX---?XX-X---XXB--X---------X?X--XXX-oXX--XX---?oX--------?EoX--XEX-XXX?--XXEXE----?o-?--
---X??B----?---XX--?X-?X----o-X--?X-XX----XXXXX?X-XXX?XEo-?-------------XXoXX?E--XX-?E-??-X?-o?-X--?X--XX-XX--oXB-?-XXE-XXo-XXX-oX-?-o---?-XEXEB?XXXXX-X-X-----XEE----oo-XX-EXXEX-XXXB-?-XXX-XXo--X-EX--
--XXE----?E--oX-Xo--XX-X-Eo-?X?---X-X-E---XX--?XX--XEX---?-XX----?----X?XoXX-E-MXX-------XX?-??XXXXX-BoX?XXX?-oX--XXX-X-XXXE-X---o-o--------X-o---?XXX--X-XXX-o-X-X-X--X-X---XXX-XXEXXX--X?-XXX--X--XX--
--XB--?o-?oo---X-o--XXXEX-o--X--?XX?XXoX-X?XXo-XX?X?XX-XB?-X----X-?-?-X--X--X-EXXX---?M--XX-?oEX------XXX-EX-XXXoX-XX-XX-EXXX----o---------??X--o--X-X-----XXXXX-X?X--E-XXo-?oX-XXXX--X---XXEX-X--X--X--
m-XXX---oX-X--XXXXX-Xo-XE?-X-X?--X---XX?X-E-X---X-XXXXXX-?X-?-XXX--?-XEXX?-X-XX-EXXXEXXXXo-XXX-XXX--X|XXEX--XX-XX??-X?XX-X?XX---??-EX-?--oo-XXo--XX-?XX-XXXXX-XXE-X??--X-XXo-XXXX?EXX-X-EE--EXXXE?-XXB--
XXXXXXXXXXXXXXXXXXXXXXXXXXXXXXXXXXXXXXXXXXXXXXXXXXXXXXXXXXXXXXXXXXXXXXXXXXXXXXXXXXXXXXXXXXXXXXXXXXXXXXXXXXXXXXXXXXXXXXXXXXXXXXXXXXXXXXXXXXXXXXXXXXXXXXXXXXXXXXXXXXXXXXXXXXXXXXXXXXXXXXXXXXXXXXXXXXXXXXXX
