--------------------------------------------------------------------------------------------------------------------------------------------------------------------------------------------------------
--------------------------------------------------------------------------------------------------------------------------------------------------------------------------------------------------------
--------------------------------------------------------------------------------------------------------------------------------------------------------------------------------------------------------
--------------------------------------------------------------------------------------------------------------------------------------------------------------------------------------------------------
--------------------------------------------------------------------------------------------------------------------------------------------------------------------------------------------------------
--------------------------------------------------------------------------------------------------------------------------------------------------------------------------------------------------------
--------------------------------------------------------------------------------------------------------------------------------------------------------------------------------------------------------
-------------------------------------------------------------------------------------------------------------------------------------------------------------------------------------------------------v
--------------------------------------------------------------------------------------------------------------------------------------------------------------------------------------------------------
-------X?o---B-E---M-B------B---?---------Mo-B---E----?--EXEB--o---E-o-E?o-----B-M---X----?---XXo---------------B--MM-----?-o---B----E--?-X---M-o-E-E-o-----B-----M--?--X---------o-----?EE-B-B----?-M--
----M---XE-?-E------?---?-BM-o----E-Bo---M-B-----------E-X-----o-o-----------E-------X---E-M-X-X----B?-oE-?M-MB--B--?----?--oB---------ME-EX-----?---B----?-----?---M-E-XX-----E--E-?----------------o--
---?-----X------B--E?---ME---oE-oo----?----E--o-----BB----XXE------?----------------X--E-E----X----MB---E---Mo-E-----M?----------M------B--X----?E--M--BM-?-B---M-o----XXoB--------M-oEo----B----B------
---B----X--M--EMB?-oE---?--------E-------?o-----oo----EEo-?XM------XMB--B-----oM---MXEM--XBXXX-X-B-B----?--E-----------X-----M--BEo---?----X----BE---------------MX----X-?o--M--------M----o-o----------
--oX----X----EEX----M----M?----XoXX-B-BX-X-oBX----EB------X-X---M-XBBE--o-B-o-M--?oMBX----X--X-X----o--X--M?M--?-?B----?X------EE-X--oM-o--XX---o--?------------XX-MM-X----?--o?------E--?X-o-MMMX-X-M--
m--XB-E--X--X-XMX--B-?--X-X--?--XXB-M--XX-X?-XB--B--M--B-EX-XX----XBX--oE--X--EoX-B-oXMXXB-XBoX--E--o-XBEB--BX---B--oB-X-E-?-E--BMBX---X---X-o-E-o-X---?--o--?--XX?--XoX--------XX------XXBX-M--X-XX----
XXXXXXXXXXXXXXXXXXXXXXXXXXXXXXXXXXXXXXXXXXXXXXXXXXXXXXXXXXXXXXXXXXXXXXXXXXXXXXXXXXXXXXXXXXXXXXXXXXXXXXXXXXXXXXXXXXXXXXXXXXXXXXXXXXXXXXXXXXXXXXXXXXXXXXXXXXXXXXXXXXXXXXXXXXXXXXXXXXXXXXXXXXXXXXXXXXXXXXXX
