---o-------------------------?----------------?--------------------?--------------?----?---------?----------?----------E----o-----o-oo-------------o--------------E--------------------o-------?--------
----------------------------o-E-?-------------------------?--?--------------o------------E---------?-----?-----------?-?-----------------o-----?------------E-----?---o----------------------o-----?----
--o----?---?-------o----------?-------------E----?--------E----o-?----------------------E---E----E----?--------------------------------E----------------?-----o----------------E-------?----------------
----------------------o-----------o-?------E--------------E----------------?---------------?------------o--------------------?----E-----?--------?-------------?-------------------?-------o-----?------
---------------------------?----------o--------------E----------------?----------?--------------??-----E------E-----o-----------------------------------------------?-----------------------------o---E-
---------------?--o---?--------------------------------?--------?------?--------??o------------------?--------?-----------------o-------------?-----?--------------------------------?------------------
---?---------------------?-?---?----------------------------o-------o---o-----------?-----E---------o-------o--------o------------------------------E?------------------?-?o-----??--?------------------
----?---E--------------?-------o?------?o-E------------------?-E----------------------------------------?---------------?E-------?--------------------E----?----------?--------------------------?-----v
-----------E-----?-------?----------------------------------------------?---?---------E-------------------E-E--?---------------o--------------------------------------------?--?--------?-----o--------f
---o--o----E-----?-------------E------?------------------------------o-------------------o----------------------------o--------?-----------------------------E-----------------------?oE------E------E-f
-------------------o------------------------o-----?------------------------?o--?--E-------------o?-----------?--?---?--E------E?---?--o------?-----?-?---------------------------------------------E---f
-------?--------------?--?E-----o---------??-----?-----?----------------------E-------------------?--------------E---------------------------------------?----?-?---?----------------------------------f
----??-------o-----------------?-----------------------E----------o------E?-------------E-------------------?---------?--------------------------?------o---?o----------E----------------o-T----------?f
------------?--?----------------o---------o-------------?-?--------------?o--------------?-------------o-------------------E-?---?--------------------------------------------------|------|-----------f
m---|--|?---|----|---E------?---|--------||----?-----|----|--------------E------------|--|-|---------|-----?--------|------|?--------o-|-|---?E-------------o|-||-|-------|---------|---|--|---|-E----?X
XXXXXXXXXXXXXXXXXXXXXXXXXXXXXXXXXXXXXXXXXXXXXXXXXXXXXXXXXXXXXXXXXXXXXXXXXXXXXXXXXXXXXXXXXXXXXXXXXXXXXXXXXXXXXXXXXXXXXXXXXXXXXXXXXXXXXXXXXXXXXXXXXXXXXXXXXXXXXXXXXXXXXXXXXXXXXXXXXXXXXXXXXXXXXXXXXXXXXXXX
