--------------------------------------------------------------------------------------------------------------------------------------------------------------------------------------------------------
--------------------------------------------------------------------------------------------------------------------------------------------------------------------------------------------------------
--------------------------------------------------------------------------------------------------------------------------------------------------------------------------------------------------------
--------------------------------------------------------------------------------------------------------------------------------------------------------------------------------------------------------
--------------------------------------------------------------------------------------------------------------------------------------------------------------------------------------------------------
--------------------------------------------------------------------------------------------------------------------------------------------------------------------------------------------------------
--------------------------------------------------------------------------------------------------------------------------------------------------------------------------------------------------------
-------------------------------------------------------------------------------------------------------------------------------------------------------------------------------------------------------v
--------------------------------------------------------------------------------------------------------------------------------------------------------------------------------------------------------
-MM-?-o--B-o-MoXo--B---M---?----------?-M--------?--------?-?-M----------?---------?---oM-------------E-M---B----o---M?X---M---E?o---------Mo--EM-B--E----M-X-EX----o?------B-B-----?-------E---o-B-----
----------B-X-o-XXX-B----M--------------E-M--?------------BoB------------------M-Mo-------------E----o-oM---?---M---?--oXEX---M--?M-----?-----------------X-X-X------o-o--oB---E?--M---o-?--Eo-B-----o--
---oE-------?XXXXX--o--o-E-EoM-?------?E--BE?-Mo---?-------BM----B----E---Eo-??--E----BoM?---B----Bo-oB-?---o--Bo-------XX-------?---MB---o------E-----M--MXXX--B-----?----M----------E-BB-----?-M------
--M---XM-oM--oXo-X------o--?------?---X-o----M----o-X-?----M--E-?o-o-??-E-MoEMX-----------E-?----------B---M-------MME-o-XM-----o---XB---M?B---E------------X-----?ME-o-XB----Eo----E-M---oM--o-M?---E--
--E----X--o---EXX---o--------B-?-------XX---XX----X-X-XX-------MX----oBEM---oX---?-B-------?--E?------XoM--B-EMo------BE-XXX-Eo--Xo-XE--E--??--EE--E--EE-?-X-------MX--X-X-B---MM--oXBXX--?---E-B----E--
m--X-X--XBXEXM-X-?------E-?-M-?M-E--M--XoB--XB---X?--XX--XX---X-oX---BE-o-?E-X-oX-o-o-?--o-X-XM--M?-?XM--M-??--XMX?-XoB--BX---M-XEMMX---E--B-E--X-E-XB-E-MXX--M?-----XX-?XX-----B-?E-X-?XX?--EEXBE-E----
XXXXXXXXXXXXXXXXXXXXXXXXXXXXXXXXXXXXXXXXXXXXXXXXXXXXXXXXXXXXXXXXXXXXXXXXXXXXXXXXXXXXXXXXXXXXXXXXXXXXXXXXXXXXXXXXXXXXXXXXXXXXXXXXXXXXXXXXXXXXXXXXXXXXXXXXXXXXXXXXXXXXXXXXXXXXXXXXXXXXXXXXXXXXXXXXXXXXXXXX
