--------------------------------------------------------------------------------------------------------------------------------------------------------------------------------------------------------
--------------------------------------------------------------------------------------------------------------------------------------------------------------------------------------------------------
--------------------------------------------------------------------------------------------------------------------------------------------------------------------------------------------------------
--------------------------------------------------------------------------------------------------------------------------------------------------------------------------------------------------------
--------------------------------------------------------------------------------------------------------------------------------------------------------------------------------------------------------
--------------------------------------------------------------------------------------------------------------------------------------------------------------------------------------------------------
--------------------------------------------------------------------------------------------------------------------------------------------------------------------------------------------------------
-------------------------------------------------------------------------------------------------------------------------------------------------------------------------------------------------------v
----?---E---E--------------------?-o---------?-----?-------?E----o------?-----------------E--E??E----?--?-o----------?------?---E------?----?E-???----o---?-?------------Eo?---E-----o----?----o--------
-?------o--?-?----------??E-o-------?-?--------------------o??--------o----o-----E------?----E-?----EE-----??----------o-----?-----------?-----E?o----------oE---E-E?E---o---?-----------o--------o-?E?-
---?-E--Eo--?E--------E-?-o--E----?--?--o-----------------?-----?-----EE?----------?E-?----Eo-o--------?--------o---------E---??----E-?o--o----E---oE---------------o-----??--------------------?-------
---???---o---------?------?------?----??---?----?------?----o--------?---------E--------------?o---?-o-?-?---------?-----?-E----???------??---?-------------E-?-EE--?-----------EE?-E---------E---------
-------?--o---o-------E-------E-E-o----------------?---EE---?---?-----?----??---------?--E---?EE-?---------------o-------?----?---------?---E-?-----E--o-------?--o---?------?--?-----?o-------------o--
---?---------------?--o-------?---------E---------o-----------------o--Eo------------o??-o--?E--E--o?---o---o---?--EE------?-?--?-?--E-?----?-------------o---EoE-?-------??--?o----??----------------?-
m---|--X--X?--XXX---XoX--oX-X-XX|-XEX-XXX-E?-|-X?-X|--o-XXE?-|X-X--X------|--XXX|-X-|-EX-E-|-XX?X-X-?XX|XXXE-----?XXoEXX|XEoX?--X|--X--|---XXE-X-E-----o|?o-EE--E-??XEXX??-XXX-?X-X-XX|------?--XXXX|X--
XXXXXXXXXXXXXXXXXXXXXXXXXXXXXXXXXXXXXXXXXXXXXXXXXXXXXXXXXXXXXXXXXXXXXXXXXXXXXXXXXXXXXXXXXXXXXXXXXXXXXXXXXXXXXXXXXXXXXXXXXXXXXXXXXXXXXXXXXXXXXXXXXXXXXXXXXXXXXXXXXXXXXXXXXXXXXXXXXXXXXXXXXXXXXXXXXXXXXXXX
