--------------------------------------------------------------------------------------------------------------------------------------------------------------------------------------------------------
---?---------------------E------?--B-M------E--------------------o-E---Mo-------------o-------oM?------EBM-----?--?-----------------------M-------------M-----o-----M---B-------------------------------
---M-------o----M-?-----B----------??-----E-----------------------E----M-------B-------------B----------BE---?-----------B------B-M-o-?----------------?B----------oB---------M-M---o-------oM----------
---M?-B-o---M-o---------o-oE--------------o-o?o-------?----?-------B------------------------o-------?---B--E--------------o----------B---o-o--M-E---?--------------------o-----?-B-----------o----------
-------------------B---E-B-??-----------B-E?--------M--B---?-----------M-------------E-------B------------M----E--------------?------------M---------B-o-E---o---?--?--o----M--o------------------------
---BM?-o--?-?E-o------------------?-----Eo--------?-------B-M---MB----?----?-------------?-M-------B-?B---o---?o----??M-B?------B-?----M--BE-----------B-------B------M?-M---E------?B??---B-X----------
---?-Bo-?--------------------------B--o-??------E-----o-o---B-M-----o-?-----E----M-----B---?M-?----E---------------M---?----E-----B--B--oE---M-?--?------------E------------B--o-E------oo-EXM----------
----B-?--E-o-----Eo--o-----?-------------Eo-?-----------M-EBM-?----M--------B---o-B----------M-E---------B---------B-----?o-o---------------E--?--------B-?-o---------?---?-M--------M-E---ME----------v
--B-----------o---?--M--M-------E-?----------o--E-B--B------------E-M----------M--------B-o-------MB----------------MB----o-E---E----B-------B------M---E----B--?oM--E-?----?--M-------------?---------f
-o---o-?--M---------o-o--------ME-B-M---E-----M-oM----?-o----M-M--?--E---B-?-----?------?------B--?--------??-??-----o---------?-E----?-----o--E--?--M?--o----E-B----B?--B--?-----?M-M--B-?-BX---------f
----M-B---?-E----oo--E------------o---E-MTB-------B------?---M------------MMB-o--?--B?-?----E-----M-B--------M|---oE--------MM-----------M-----?o-M-M---?-E?----B--oo------??-MM------------XX---------f
----o---E?---o--E-------------TB--?------|------o-E--o--M-?--M-M----B----------EMo------o---o-?-?---E------?E-|----------------?--M----Mo--o?-M---EM-?-oM?-------E----------o-E---o--o---?--XX---------f
----||-|--BM--E-TT----TEBX--X-|---E----TB|-o-T---|-----MME--E-MXX----X-------oE--|---B-o-T-----oT|-|---X-o----|-o--M--B---B-TE--------MB------M---o------?-E-E-o--M?E------|ME----------B-E|-X---------f
--XX-|-|--TB----T-|-XX|-X--|-X|T|T?Eo-X-EE-To|-TX|-??ET-ETEM-TX-BT-TEXM|---X--|--|M-TM-To|TE-T-TE|E|-X|-|B|-TB|-TET|-|----o-|E-TB|--ME-|-|--T--|-XX|-XB--X-?|-|---E?-|--T|-|-X|--MT|---TX-T|-|---------f
m-X-X|-||-|-|-|-|-XoXE|MX|-|-M|--|-|--M-MEM|-|-|E||--B|--||-X|-X-|-|-|-|---X-X|-B|--|--|-||-X|-|-|-|--|-|-|-|-|-|-||-|-|-|-X|-X|-||-XXM|-|--|--||-X|-X|BX|--|||-E-|-?|-?X|-B-X|---B|-|-|-X-|E|---------X
XXXXXXXXXXXXXXXXXXXXXXXXXXXXXXXXXXXXXXXXXXXXXXXXXXXXXXXXXXXXXXXXXXXXXXXXXXXXXXXXXXXXXXXXXXXXXXXXXXXXXXXXXXXXXXXXXXXXXXXXXXXXXXXXXXXXXXXXXXXXXXXXXXXXXXXXXXXXXXXXXXXXXXXXXXXXXXXXXXXXXXXXXXXXXXXXXXXXXXXX
