--------------------------------------------------------------------------------------------------------------------------------------------------------------------------------------------------------
---?--------------------------------------?-----------------------------------------------------------------------------------------------------------------------------?-------------------------E-----
------------------------------------------------------------------E-----------o--------------------------------------------E----E--------------------E--------------------------E--------?--------------
---------------------------------?----------?-------------------------------------------------E---------------------------------------------------------------------------------o------------E----------
---------------------------------------------------------------------------?------------------------------------?--------------------------------------?-----------------?------------------------------
-----------------?------?-------------o----?-------------------------------------------------------?----------------------------------------------?---o--?-----?-----------------?E-?---E---o--------o--
-?---------?E--------------------------------------E---?-E--------------------------------------------------------------?--------------------?-----------------?--------------------E----------------E--
------------------------------------?-----------------?--------------------------------------------------------------------E---------------------------------------?-----------------------------------v
-----------------------------E---?------------------?-----o----------------------------------------------o----------?----------------------------------------------------E----------------o------?------
--?-o-------o------------?--oo----E---------?o?---E?---------?--------o-?--------E---o--oE---?-----?--?----?o---?--------?o?-----?------?-----------?-----o---------------E-------Eo?o-----o-o--?-?-E-o-
-----o-E-Eo---?------------?-o-?--?-??-----?------?E----?-----E-------o-------?------------E--E--------?-o---E??-------??--------?-------E------?-----------------E--?-----------------EE--o-?E--?------
-?------o------??---o---oE-----o-E-?------E----------E------o?--E-?--?--?---?--------------o?---o-?-------------------?------E--E?---------------o-E???E?-?----E---------?---?-----EE-----?--E--o?------
-----------?-----EEE--o-??E-------?-??E?E----?---o------------T----------?----E?----?-------------o--------T--?T------E---?-----E------?-E----E-o-E-?----o--------------------o---?--------o------E-----
--E?---?---?-----------?--E-?-?------?-?--------ET---X-----?-?|T-E-?T-?---E----?-----------T-----------?---|---|-?T-o--?-?-----?---T-o---?E-----TT------?-Eo------??----?------T-----?-----?-T|-TT---Eo-
m-X?--X----?----o--?--------------o-XXE-X--------|-|X----?|---||-E-||?-------oo?--?-||X-?--|--X---??o-------X--|X-|--?-------?-----|--E---------||-----|---?-X-----|--------?--|-----?X-?-?--||o||----X-
XXXXXXXX-XXXX-XX-XXXXXXXXXXXXXXXXXXXXXX-XXXXXXXXXXXXXXXXXX-X?X-X-XXXXXXXX-XXXXXXXXXXXXXXXXXXXXXXXXXXo-XXXXXXX-XXXXXX-XXXXXXXXXXXXXEXXXXX-XXXXXXXXXXXXX-XXX-XX-XXXX-XXXXXXXXXX-XXXXXXX-XX-XX-XXXXXXXXXXXX
