--------------------------------------------------------------------------------------------------------------------------------------------------------------------------------------------------------
------------------------------------?-------------------------------------------------------------------o------?-----------------------------------o----------------------------------------------------
-------------------------------------------o----------------------------------------?------------------------------------------------------------E------------------------------------------------------
------------------------------------------------------------------------------------------------------------------------------------------------------------------E------------?-------o----------------
----------------------------------?-----------E-?------------------------------------------------------o-------------------------------o------?--E-------o---?------------------------------?-----------
--------------------------------------------------------------------------------------------------------------------------------------------------?-?---------------------------------------------?-----
----------------?----------------------------E-------------------------?--------------------------------------------------------------------------------------------------------------------------------
-----------------------------------------------------------?------------------------------------------?-------------------------------------------------------------------?----------------------------v
------------------?--------------------------------------------?---------?-------------------?------o----------------E-----------------------------------------------------------?----?-----------------
---------?-?E-o----o-o----?-E-?-?------------?------?---Eo-o---?-oE---o-?------------?o?E??-----E--E-?E---Eo-?-----?E---o-----?------?-------o-------?--E-------------------o---oE?---------?-o-?---E---
----?---------------o--?------?--------?--?-----?--------o---o------------EE------?-?-E-o--?E-oE-------o?--?--?--------o-----???-E-?---------o--o?-E?-----?-?------------?----?E-------o-------?o-----E-
---o-------------o---o-T-------E----E-?o-------?-----o-?-?-----?EE-----?-E?-?-?---?-?------?E?-?----?------------o-------E--E--E--------?----------o----?--E--o--------E?---------o----------????-----o-
---?---?E----oo--------|--E----------------------?-------------o------EE-----??o-------------------E----?E----o---?-?-E-------oo-E---?------ET--o-E-o-------E---E---E-o----?-----o-E--?------?--ooX---?-
----?--o------EE---??-oT---T--?T---E-?-o--?-??-----?---o-----------o?----------T??------?------E----E--?ET---?-----------o---?----------T-o----?-----------E-?-?---?-----E-?-----???--??E?-o-----E-X-E--
m--o?o-?-E--EE|--?|-E--|X--|-E-|-------o-----?|--?-|--?-----X---E---oo--E----?o--o-----?------?E?--------|----oX|E|---------?-?E|---?---|-?o-X-X--Xo-E-----X?-----X---?---o----??-EE----------?----X----
XXXXXX--X-XXXXXXXX-E-XXXX-XXXoXX-XXX-X-X-X-XXXXXXX-XXXXXXX--XXXXXX-XX?XXXXXX?XXXXXXXXX-XXXXXXXXXXXXXXXXEXXXXXXXXXXXXXXX?XXXXXX-XXXXXXXXXX-XXXXXXXXX--X-X-XX--XX-XXXXXXXXXXXXXXXXXXXXXX-XXXXX-XX--XXX-XXX
