-TX--M-|XEo-M--|E-TE-E??T-o----??-|---TMB-o|-B-TB|XXXX--XX-E?E-|M-?--E--?X----?|MT-EMB-BB----?-MB--B?-----|-o--o?-E---o-BX?---o--|TMo-Bo-?-X-XT----X|o|--o-|---E|E?BoX--o--X--TE-o---BE-M?-ETMo?EEMo--?-
-TE--B|M-----XBo--?-oM--oX|-o---B-?---|-T------?Bo-----MTB-X--E---XXE-E-X-E-X-|M-X|---Mo-Xoo?--XM--|B--ooT-M-||-|o|XoE--?MM--?-?--?-oB--B-X----EX-EX-EET-o-?XM-||E--X|X|-MXX?-?BBoEMo-|--o--M???--B---M-
-EX-o--oB--?Too----EX-BX-|oB?E-E-|Bo|X-E?-T|T---M-X-X|T-X-B-X|Bo--?|--E--M-XM|-----EM?E---T---X--XB?---XX?oE|----B-E--BEEB--T--o-E-EXT--M-XEXTBBBT-M?E--oo??T--Bo-T-?oBTMo-|oo-ET--o-EMo--|-M-EM-----MB-
-E--M|?B----?M-|T-B-E-o?|---?-?M?oBBo-?--o|B-B--T-T-?---?---o-|oX-|X--M-X--M?T--oMoMME-?B-MT?----oEX-o--T---|E--T-E-|B-BEE--To-XT-BB--X---||Mo-E-M--T--X-M-B--?-B----|ooX--MMT|--E--B?--E|T-EBET-E---|o-
-ETo-?ETE|o--TE--X-o-B----Xo?-TM-||o-|--X-?o--MB-XBTT-X--o--Eo-T|M-E-o--MEXX---o----T-TXBToT-oBEBT?--|T-EB?X-----|E-M|-B-EB--|--M--EE-BE-X---?-B?-?M-oX-TX--|M-?E-oE|----??--|---XBE--M-BT|X-T-M--?---?-
-B----E|M||-T-M?MTo-XT||-E--EoM-?B-X-|--B-----XB-o-------B-M---o--TT--?-TEM---|-B--|--E-B--o-|?To||-|-X--E--?---E---B?--EB---Eo|ETX-X----X-XT-B--oT---?-BEX--MB??-E-TE-X-?B--E?-EM-oT-TT-----||TBME--o--
-|XB--MX-?-EBX---XTMX|TXT--EToTE-|--X--M---?--||X-oB-T-o---B----ET--|-XBTTX??M--X?-B----|XB-T-XB-B-E--X--B|--?--X-TMXTM-oo--X-M--M--|MX-E--o---TT--?-|M-o|TEE--|--T--|BBTo-BEM?-|?BT-MBMXX-MB-o------BM-
-o--B--|XT-T|----o|X--TEE|B-BEM-B--ToB--To---XTX---EB|MT--B-T-TTXX-MT?|-o--XEMoBM-o--??---?XE--M-B-X?---E-??XEo-BoXoB?---M-B|?X-E---BE?||oB|T?---To---B|--E??ET|X-|--|----E-EXX?E|----X---??o---BBE-?|?v
--BXT-XT-MX-oET--M-BE--T----M|------|B?BoBTXEB-|XTBB-T-X-?-Bo-X--X--BT-XXX?B|?o-?M?B--E----XEX-?E?-?-E-oM|----o--X--oB-METT|-M-T--X-E----M-TBT-o--o--BMEM-MM--M|-E--?-o?-XBo|-B---T--X---MXB---|E-X--X|f
-TE---?-BX|X-o--T--?oX|TT--oT|M-E-|--E-|-|-BoE---Eo-EEE?T-?-E-Eo--oM-TX-|-?--Xo|--X-E--M--MTX-|----E-|o-X-BT-E-MX--X?T---?-----BTME-?BM?TT-B?XTB-E?XXEM?|XMTB-?-|M----X-TT?B--BETE---BBTX----X|-ooBo---f
-o-TXT-?-XT--E-?o-|----?TM-E--|--E|M?|-M|B-|XoX-|-TE|TM--XBEBT---T|-||----o--E--B-|??---|-MX-|-o--M--B|-----BT?--||-Bo--X|o----X|-M-EX-o|--XE|oB---TTE-----Too--T--TET--BB?-E-MBME----?---?MEB?-TEM-|BEf
--B-----E-X---TE|--||-MM-BT|B---oo-?T-|?X-XEB||-?--E----T-?B|XX-o---E---?---XEME?TX-Bo----oM---BM?T-----|B?To--|MB--BB-o-M-Mo-TM|-o----TMB-M?|XE--|-T--B---M---oX---M|BX-M--|---Mo--XMEo?B|M--|?XMX-|Mof
---o|-TB-B?-|--?-BTE?Eoo-?-------T-E---B-----EX?XMo--?-oo?o-M-M-|X-|-MXT-E-M-E-o-BX--B-XE-TBE-B?---oE-T?M--X-M-BB-E--||--o-M-T-|M--EBXM--|-X-E-B?--ET-?-M|BE-X|--|-|EBX|-oE-?--|--||?BBX---E--?-o---Moof
---B-|-E-X-o-?--X-|---|B--M-B?--oB-------X?M-o-B----EB-o-TX----B--|-ooXoE--|o---?-?o-EEM|-E-?-?XTM-oB|--?T-Mo-?--T|T-T-o-E|-B?-?o--M--MoT?B-TM--oMBoEoM--TB-Xo-TXM------?-?T?|X?--o?|X--ETEoEEo?-E-E-Bof
mXo?|TXXoXM---?MM----BB?BT--|---oBo--XTB---?M---MXT|XX||o--B?-ooBE--EoB?o-?-|MB?--|-?BBBB----|--|B|--T?M--?---Xo-BMo-o-|-----X|?----BB------|-EX---o?X-EB?||-M-T-B-X---B-EE-EX-o--To--E?TMM-TTEE--T----X
XXXXXXXXXXXXXXXXXXXXXXXXXXXXXXXXXXXXXXXXXXXXXXXXXXXXXXXXXXXXXXXXXXXXXXXXXXXXXXXXXXXXXXXXXXXXXXXXXXXXXXXXXXXXXXXXXXXXXXXXXXXXXXXXXXXXXXXXXXXXXXXXXXXXXXXXXXXXXXXXXXXXXXXXXXXXXXXXXXXXXXXXXXXXXXXXXXXXXXXX
