--------------------------------------------------------------------------------------------------------------------------------------------------------------------------------------------------------
------------------------------------------------o---------E-----------------------------o----------------------------------------------------------------------------------------------M----------------
-------------------E---------?---------------B--------------------------------------------------------------------------------------------------------o--------------------o----------------------------
----------------?------------?-?------------?------?----------------------------------------------------------------------------------B---------o-------B------------------------------------M-----?----
-----E---------------------------B--------------------------------o--------------B------------------------o---------o-----------B------------------------B----------------------------------------------
-------------------------------?--------B------------o---------------------------------------------------------------------B-B--------------------------B-------B---------------------?-----------------
--?------------------E------M----------------?----B--------------------------B-----------------?--------B----o------------------------------?-----o-------------M------?----------B-------------o-------
----------------------------?----------------o---------------------------------------o------o----------------------------------------------------------------------------------------------------------v
-------------------o-------------------------------------------------E--------------------Bo--B----------------------------------------------------------X----------------o--------------------Xo-------
--E--?---------?---oXX-XXX-----?---?-----?-----o--EEoX-o------?-----EXEoXEX--?-o?-?------?----?-XEoXX-------o-----?-------?--E-?------?o---------E---X-B-X----E----?----X-E-X?--o?X-??--?XXBE-XE----?---
------o-------XEo--X-X--X------E------o-o----?---?XXX--o-ME-----o?X-E-X--XXX----------??--?-----XXXEXo-----?----------------?--E---o-------E------E--EX-X---------------XX---X?--Xo?--o-XXXX-X----E--E--
--X--?-----E--X-----X-E-X-X------o?M--EX?X--o--Mo--XX-------E--?-?-X-X---XX-----??-ooo-o---o---?EXXX-------o-XXXEX-Xo-?----X--E-E?E--------?-E-------XXX----?------?--Eo?X-XXXXBX?X-MM---XX---X-oE-M-E--
--XB--TB-M-X?XE----X-----X--E---?---E-EXX------E----X---E---?-E-?-XE-X-?XX------XX-??--X??-----EX-XX----------XXXXX?-?o---X-o-----X-?oo--o-----?--?-?-X-T??---?-E-o-X---?--oBX--X?XX----XX----X-----?---
-----?|----EBXo---XE------XX-X-E----T--X?T?X--??-X--XETE--?--X-E-XX?-XoXXXXX--o-EX?o--XX-----oT--XXT-----o-----X-X----?--E----TEXXXo-----|---?-?----?X--|?-o---TT---?E--E--X?-X-XX?-X-XXTXX---oX--T--o--
m-X--X|X-oXEX-oo-XXEo-E--?X---?-X---|-o?X|?-XX---X--X|||-XX?XX-XX-X|--X|--X-EEX-XXE--XX----E--|-XXX|--oXEE-E?--X-XEX|----|E?--|X-X-?--|-X|EE---X|-XX-M-?|------||o?--X--E--XEXX|-X-XB?XE|X?-??-X----EoX-
XXXXXXXXXXXXXXXXXXXXXXXXXXXXXXXXXXXXXXXXXXXXXXXXXXXXXXXXXXXXXXXXXXXXXXXXXXXXXXXXXXXXXXXXXXXXXXXXXXXXXXXXXXXXXXXXXXXXXXXXXXXXXXXXXXXXXXXXXXXXXXXXXXXXXXXXXXXXXXXXXXXXXXXXXXXXXXXXXXXXXXXXXXXXXXXXXXXXXXXX
