--------------------------------------------------------------------------------------------------------------------------------------------------------------------------------------------------------
----M----------------------o---------------------------B-----------M---------?-------------------?------------------B--M-------------M------------------?---------------------B------------------B------
---------------------------o-------------------E----------------------B-------------------------?--?---------B-----------------------E-----------------------------------------M------------------------
------------------------------------------------------------------------------------------------------------------------------------------------------oM------------------------------------------------
-------o--------------------------------o----M-----------------E-------------o-------M----------------?------------------------------------------------------------------------B--------E---------------
-----B-----------B-------------------------------o--------------E-----?--------M--------o---------------------?-----------------------M------------------------------------------------M--?--------B----
--------------M----------------------------------------------X-------------M----------------------------------------------------------------?----------?---M------------B----------------------------E--
----------------B------B-o------?--------B--------------------X-----------------------E--------?---------o-X------E----X------------E----M----------------------------M-----B--------------------------v
--------------------------------?-----X-BX---E-----------------X--------------X--o--------------------------XX--------X--E------------------------------------------------X------X-----o---XX-----------
--XX--o------?o--?----o----XX-E--X--XX-o-X-XX?X-XXoX-?-?----XX--X--XEX-X----XXXXXXE--XX?o-----?o------?X-XE-XX-o---X?-?X?-XX-o---?-XXX----XX----?---E-ooE-X-oX?X---?X?X?--X--XX--X-o--X-XMXXX--EXX?XXX--
--?X--o-?---XX--------Eoo--XXX--X---EXX--XEoE--X--XE-----??XX--XE---XXXo-?--EXX-X----EX?-----?-?o---?-oXXE?EX------X?-X-XXXoX-------X----E-E--?----------XX--XX?-E?-XXX---X-XX-X-?o-?-XXX--X-?-oXoXXX?--
--X-E-E--X-?Xoo--?-----Xo-E-XX---X??Xo-XEX-?X?--X-X-?----X-XoEX----o?X----E--EXXM?XXoXXoE-?-------------XX-XX---?X-XXE?XXXXXXX?E------?-----?oo--------XX-XM-X-?---X-XMooEXX--X?XX-o---XM-X--X?X--XX----
---X---XX?XXX-XX?XX-XX-o-X-?-X-X-X---X-XXXX-XXo?-X--X---o-XXXX--XX-Xo-XE-E?-o-?X?XX---X-XXXE--?-?----?-o--XXo--E--XXXXXX?XMX-X?--E?-XXo?----E-------o---X-XXX????-?-XXX---XXX-X-X-?XX?-oXXXE--X---oXoE--
--X---X-XX-X--XXX--X-o-?X-?-XX?-X?----XX-XXXXXXEXXXX?o?--X-X-X-XXX-XoEXEX---XXXXXX?-?o?X-XX------?---o--XEX--?-?X-XE-X-oXXXXXX?-o-?E-X?Xoo?-?----------X-M-XXX-X--oX--?-E-XoXoMXX-X------X--XXX--EE-XX--
m?X----XX-X--XXBXX-oXXXX-EXXXo|o-XE-?XXM-X-XXX?-?XXX-?--XX?-EEX?X--oo-X?oXX-XXXX-EXXooXXXXXX-?----EXXX-X-?XX?-XXX-X--?XoXXX--XXXXXE-o-XEX--X?o?E--?E--X-o---X?X--X-XE-Xoo?X-XEXXXX-E-XXoX--X?X-X--XX-X--
XXXXXXXXXXXXXXXXXXXXXXXXXXXXXXXXXXXXXXXXXXXXXXXXXXXXXXXXXXXXXXXXXXXXXXXXXXXXXXXXXXXXXXXXXXXXXXXXXXXXXXXXXXXXXXXXXXXXXXXXXXXXXXXXXXXXXXXXXXXXXXXXXXXXXXXXXXXXXXXXXXXXXXXXXXXXXXXXXXXXXXXXXXXXXXXXXXXXXXXX
