--------------------------------------------------------------------------------------------------------------------------------------------------------------------------------------------------------
--------------------------------------------------------------------------------------------------------------------------------------------------------------------------------------------------------
--------------------------------------------------------------------------------------------------------------------------------------------------------------------------------------------------------
--------------------------------------------------------------------------------------------------------------------------------------------------------------------------------------------------------
--------------------------------------------------------------------------------------------------------------------------------------------------------------------------------------------------------
--------------------------------------------------------------------------------------------------------------------------------------------------------------------------------------------------------
--------------------------------------------------------------------------------------------------------------------------------------------------------------------------------------------------------
-------------------------------------------------------------------------------------------------------------------------------------------------------------------------------------------------------v
--------------------------------------------------------------------------------------------------------------------------------------------------------------------------------------------------------
-------?---MoM---XX-Mo-o--B--E-------------------o-B---------XXM-----M----E-----B---o----o-----BM------E-?----B------M--MB----B-------?-M--B----M------?E-B-oo-----------------B-----oo?--E--T----------
-o---?E---B---EM?XX----X---E-M--E---M-?-------------?----B-o--XX---Bo-----E--E---B---E-oE-E-?o--?----------o----X--oE-M-------M---B------------BB-B---?-X-------?-----M----?oo--------X-B----|----------
-BE--------------EX----oX---E--------M----M-B---?o----T---?--XX---EEBE-M-M--?--M---------E?--------M-B?-MB?MMBoX---?---Bo-B--o-B----oMBE----BBM--M-M--?X-----XXXX--M---E---oM-EME-M--XE-----E|----------
-TM----?M--TE?M---X---XX-----?---------X---T------M-E-|---B-X--X-X----M--B?B--E--To----o?--To-M-B---Bo---E-?--XX---o--?X---M----EEo--M---M-----T---o--X--E----XX--?-----oM?-M?--------XX----B|----------
-|T-T-B----|-o-----X--EX------oT-T--X-X--?-|--o-?MT---|--?-X----X---TMX-E-M----T-|--o--T-M-|-o-----?-ETEM-?X---X--T--X-X--o---T--TTTTTT---T----|o--XoX---E-----X---XX--T---T---MTMTT?MX---E--|----------
m||-|------|--------X-X-X---XX-|-|--X--X--X|--X-X-|--X|----X-----X-B|--X-------|-|---BX|---|------X---|--XXX---X-X|---XX-X--X-|-B||||||-X-|---X|----X-----X-X-X----X---|---|---X|-||--X---B--|----------
XXXXXXXXXXXXXXXXXXXXXXXXXXXXXXXXXXXXXXXXXXXXXXXXXXXXXXXXXXXXXXXXXXXXXXXXXXXXXXXXXXXXXXXXXXXXXXXXXXXXXXXXXXXXXXXXXXXXXXXXXXXXXXXXXXXXXXXXXXXXXXXXXXXXXXXXXXXXXXXXXXXXXXXXXXXXXXXXXXXXXXXXXXXXXXXXXXXXXXXX
