--------------------------------------------------------------------------------------------------------------------------------------------------------------------------------------------------------
----------M------------------------------------E-----------------------M--E----------------------------B-E-----B----------B---------B-?-------------EM-------o-----M---E-E------------M-----------------
--M-------E-------------E-------------o---B------------------------------------B--------------------E----------------------?--------M--------------------------oB-----E---B--------E------M-------------
---------------B--------------?---B------?-E---------------o--------------------------------------M--------E-------------------------------------B--------B---------M-----o--o------M-------------------
----------------------------?-----------------------------------------M-----------------------------M------------------------------?-----------------B-M---------B----M------?--B--B--------------------
-----o---------B-----?-----------------M-------E-----B---M---B---------------------E-B----o-----------?----M---------o----------------------B---?-----o---------------------B---------------------------
--?-B-B----------------E-------------E-------------------?----?-----M-------B---------------------------------------------------B---o---------------E--------?-----B---------------------X--------------
-----------------------B----B--------------------------------?-B----------------------------B----------o--B--------------------------------------E---oM-E-------------E------------B--EXX--------------v
-------B--o--?-----------------Bo--------------------------------------------------------M--E--?-------B------------------------------------M-------------------E-------o---------------XX-------------f
-BB------BMo-E-----------------?-------E---M--EEB----E---oBo------------M---o--------E------------?M-oM--o--Eo----------?o?o-----MBM----------?MB?---BBoE--Bo------B-EEE-----E-------?--X--------------f
-E----MM--EM------EX---Mo--?--B---o?-o-----B----MM-------M-E-o-----B----E----M-o?---M-X----M?----------E---?---Eo-E--M---X----o----o----o--------------BE------------B------E--M-EBE----X--------------f
--?-----?oM?o?-X-?X--E----E----EXXo--------B---M-----------M-?--T-?-----M-B---?-E---E--XX?E---o-----E------------------?X?o---B----B-?o----------M----BM?--M-M-o---o--------?-BoT------X-oM------------f
--BBo-E----T----XX---?-?------MX-XM----E--T?T----T--X---?E--T--o|B-B----X---------M----o-Eo-B-----E---EB--T--BM---M----XX----o-?-----o------T-----?----B------o--M---B-M---o----|--X--o-X--B-----------f
--XE-X----X|T---X----T--Moo---TBX--T---oo-|B|-T-T|--oXXX-To-|--?|-------X-T--T----E-oB-X-X-?Xo-TT?oTTX---T||-X?o----M--TXT?-B--?-MX-X---oTT-|-T---BE-----TE--T-?T-MTET-TT-------|-X-M-ME-oEE-----------f
m-XXX-X---X||---|-|-X|-BXXB--X|BX--|B-----|M-----|----XX-|-X|-X---------X-|oB|-X--------X--X---|||EX--X---||-?XX-?XX--X|---XX----B-X----X||E|--X|-BB|--|-||--|B-|B-|-|-X|-------|----B|-B-X-XX---------X
XXXXXXXXXXXXXXXXXXXXXXXXXXXXXXXXXXXXXXXXXXXXXXXXXXXXXXXXXXXXXXXXXXXXXXXXXXXXXXXXXXXXXXXXXXXXXXXXXXXXXXXXXXXXXXXXXXXXXXXXXXXXXXXXXXXXXXXXXXXXXXXXXXXXXXXXXXXXXXXXXXXXXXXXXXXXXXXXXXXXXXXXXXXXXXXXXXXXXXXX
