--------------------------------------------------------------------------------------------------------------------------------------------------------------------------------------------------------
-----MB---o-E--?MM?--------o---M----B-----o-?EM-------o---M-?-BB---------B---------------E----------B--M--oE----E-------M?---BM-B---?------?--?---------M-----o---BB------?--M-----Eo-------------------
----------B---o---M--Mo-------M------M----E---?-----------?------?---------o-M-o----?--------------o--------M-----------?-o-----------?-------------B--?-E------o--o--B--o--------------?---------------
-M----o?-----E--??------EM------------------oo?-E------M-oo---EE---E-----?--------------?-------E--------B----EE-------o------------M---E--o-MM-E---?---------------------?-------?------oB-------------
------------------?B-B---------------B-EBEE------M--------o-------B------B--oBEE---B---?B-B--?--EB?------E-----?o---B-----?--------------?-M------?--B-o---------?--?o-E-------?----------o-E?----------
-E---B------M?-----M--B-----E-----oBB-----------E----B----E---?----------B---E-----------E---o---Eo----E---o-?-----o--------?E---M----------E----E--B---------o?------M------------E--------B-----------
--E-B-----?-M------E----M-------M-------M------M------E--------------oM------E-o----E--M---M---E-o?--E---E--E----E----------?M--------------Eo---M?------------E---E-B----?-B-EM-----B-M---|-E----------
------------------o-----------o---------B?-B-?--E---------M--EM------E-------?----?-----?---------o--------?--------M-??-B-o----o---M----------?--------B-?-o?-------E?--------------o-----|-----------v
-------?--B---------E-M---BE----B-o-----E---------o------o--M-E---?-------------B--M---E--BB?-----E-----B---------M----B---?--?--------------B-M?----------------oM---------?-E-M--BB------|-----------f
---E---------------E--M--B---M---------E--B?-----?--------B-?---o-----o---------?-E-----E------X-B-Bo-------E------BX-----Bo-------o--M---?-oB-E-M?-MM?M--------B-M------B--oM-?-----o?-B--|-----------f
---B--B-----EM-B---B-------?---Moo--o-----E|------------B--?---Mo?-----?----B------?---------B-XMB-?---o--EM-B-o---X----??---B-------M-------?-?--M---?-?-E?--------oBo-----?B-?----Mo-----|-M---------f
--E--E-?---M------EB-?---------------Eo----|---E-M------MBB------M------E-----E-|------o------X?--------------M--BE-X-MB----B---------?B---o?-E---E--?--M---E----E----?----T-------MTM--M--|?----------f
-----M---------M-T|-o-BE--?T|---|-B--?|----|-------oM---|----T?o--|------------E|----E--EM-E?-----TE?o-X--o-E--|-M----MT----o--?TM-ET?----|--??|--o-----X?-o-E-o--M?B|-----|--ETEEM-|-----X|-|---------f
---T|-----X-----TT|-?TTM---||--T|--o--|---B|-TTo---ToTE-|-|--|--EM||TBT-?B-XB-MT|-B-T---T--o-X-T|-|-|o--X?-TX--|-|--|-B|-|B---TE|-|-|-TB-T|-TM-|---|-TB-EX--|-B---E-E|--TT-|---|---T|-TBM-M|-|---------f
m--||-|-|-|M|-|-|||-XX|--X-E|-|-|---|-|-|--|-|-||-o|-|--|-|--|--B-X||-|--oXX-XX-|-|-M|--|--|-XXB|?|-|--|-X-||-M|-|--|-X|-|--|-|-|-|-|-|---|-|-X|---|-?|oX|--||--E?|-?|--||MB|-X|-|-||-|-|-X|||---------X
XXXXXXXXXXXXXXXXXXXXXXXXXXXXXXXXXXXXXXXXXXXXXXXXXXXXXXXXXXXXXXXXXXXXXXXXXXXXXXXXXXXXXXXXXXXXXXXXXXXXXXXXXXXXXXXXXXXXXXXXXXXXXXXXXXXXXXXXXXXXXXXXXXXXXXXXXXXXXXXXXXXXXXXXXXXXXXXXXXXXXXXXXXXXXXXXXXXXXXXX
