--------------------------------------------------------------------------------------------------------------------------------------------------------------------------------------------------------
----------------------------------------------------------------------E--E------------------------------------------o-o---------o-----------------------?-E------------o-----------------B-----------E--
-o------------------------------------------------------------------------------------------------o--------------------------------------------------------------------------------------------------o--
-----?------------------------------------------------------M------------------------------------------------------------M------M-----------------------------------------------------------B------o----
----------------------------E------------------------E---B-------E--------------------------------------E--------B-------------------------o----------------------------M-------------------------------
------------B----------------------B-----------?--------------?---M------------------------------------M---------------------------------------------------M----B---------------------------------------
-------------------------------?-----------------------------------------------?---------o----------B---------M--------------------o--------------------------------M----o--------B-----?---------------
---------o-------------------------E-----------B---------------M-------------------------------------M-------------E-----------------------------------------------------o---------------------------o-v
------------B-------------------------------------?------------------------------------------------------o--------------------E-------E--------------------------------------------B---E----------------
-?o--E----?--B--oB----?-E--?----E-B-------E----E---M--E?Bo------??-B-M-B--------?B--?-M-E---M--------??o--------------Eo-o-M?--?---o--B?---?M-M---?o----------B-oB?B----B--o-----?-o-?-----------B?--M--
-------B--M--XEE---------------o--E--o-?--?E--------MMo------B---B--o---?-?-E------?--oM----o--B-E---E?--?-------B--------------M-----------?----------o---------BE-?-M----------M------------E------M--
-B---------o-X--B--o-----B--o--oo-oE-------------o-E--EE--M---M---E-B?---B--E---M-o-Bo?o--B--o-?---E?---?----------E---o-------o--------EB--------EB-o--?--?----o----?----E?--o-E-?---o-E---E--X--------
-------oM?----X---B-M--------?BE?-?--BE-------??-oM-?--------EM--M--?---B?-E-----o---M---E------?----?---BM--Bo-EB---------M-----??MB--XX-EE-?---B------M----o--??--E--?--E-------?--------?MEXE---?----
---M--BE----oBX-EE-M---o--Bo-----XM----?-?--M-XM---------B--------EEX----------B-------o---------Bo?--?-------Bo-------o---X---------B--XMB-B-?--oE-B---o-?-----E-B-X--B------?-X--o-MM-----?-EX--X-----
m-X---XM----X-MXX-XX?-?E--XM--?-X-?X--XX--E---EX-o-----o-Xo-M?---o--X-EBX--X------E--o?oX--??-----X--E--X--M-----?XX-o----X-?-o--E--E?-X-------EE-----X------B-X-oBXX--B-o-------X-EB--Xo----M-XE-------
XXXXXXXXXXXXXXXXXXXXXXXXXXXXXXXXXXXXXXXXXXXXXXXXXXXXXXXXXXXXXXXXXXXXXXXXXXXXXXXXXXXXXXXXXXXXXXXXXXXXXXXXXXXXXXXXXXXXXXXXXXXXXXXXXXXXXXXXXXXXXXXXXXXXXXXXXXXXXXXXXXXXXXXXXXXXXXXXXXXXXXXXXXXXXXXXXXXXXXXX
