-----------E-------------------------------------------------------------------------E--------?--------?--?-----------------------------?-------------------?-----?-------------------E--------------E--
--------E--------------------?E--?----------------------------------------------------------------------------E--?-------------------E-E---------------?------------------------------------------------
-------------------E--------o----------------------------------------------------o------E------?-----------------------------------------o?--------------E----------?------------------------------?----
------E-------------------------------------E--?------------------o-------------o-----------o-------------------------------------------o--E-------------------?---------------------------?------------
----------------------------?------E----------?----?-----?--------------------E-----------------------------------------------------------------?-------------------------------------------------------
----------?--------E-------------------------------------?-------------------------------------??-----------------------------?------------------------------------------------------E------------------
----?---------------------------------?----------------o---------------------------o--------------------o-----------?-o-------?--------------?----------------------------------o-----------------------
-----------------------------E---------------------------------------o------------------------?------E------o-----------?------------------o----------------------------------------------------------?v
-----------------------------------------------------------------------------------------?-o--?E-------?---------?-----------------------------------------------------------------E-------------------f
---------------------?-----------------------?---------------------------------------------------?-------------------------------------------o--E---E-----------?--------------------------------------f
-------?---o-----------------E---------------?----------o------------------E------------------------------------------------------------------------------------------------------------E--------------f
---------------------------------------?--------------------------------------------------------------------------------------------------?-----------------------------o------------------------------f
---------------------?-------------------------------------------------------------E------------------------o-------?-?--------------o-----------------------------------------------------------------f
----------------------------------o-------------------------------------?------------------------------------------------------------------------------------------------------------------------------f
m--|----------------|------------------------|-----------|--------------?-E-------o--------?---?------------------------------|------------?------|---E----------|---|----|----o--|?-|--------------||-X
XXXXXXXXXXXXXXXXXXXXXXXXXXXXXXXXXXXXXXXXXXXXXXXXXXXXXXXXXXXXXXXXXXXXXXXXXXXXXXXXXXXXXXXXXXXXXXXXXXXXXXXXXXXXXXXXXXXXXXXXXXXXXXXXXXXXXXXXXXXXXXXXXXXXXXXXXXXXXXXXXXXXXXXXXXXXXXXXXXXXXXXXXXXXXXXXXXXXXXXX
