--------------------------------------------------------------------------------------------------------------------------------------------------------------------------------------------------------
------o---------E------------------------------------------------------M-----------------------------------------E-------------M--?------------------------------------?--------------------------------
---------------------------------------------------------E----------------------------------------------------------M--------------------------M---E---?--M---------------------------------------------
-------------------------------------------------------------------------?-----------M------------------o----------------------------------------------------------------B------------------------------
-?-----------------------------------------------------------------------------------------------------------------------M--------------------?-----------------------------M----M--B-------------------
-----------------------B----------------B----------------------------------------------------E---?--------------------M-------E---------B------------------------------------?--------------------------
-------------------B----------------------------------------------?-----------------?-------------------B------------?---------E---------?-------------o------------------------------------------------
-----------------------------------o----------------------------------E-------------------?-------?-----------------------------------------------M-----------------------------------------?----------v
-----------B------------------------------------------------------------------------------X---------------------------------------B----------------X-----E--------------o---------------------?---------
--E-------?--Xo-XXX-X----M---X-E?X------?--?---Xo----?EXX----M---XXX-X---?o-------E-EX-X-XE----Xo-X----------X----E--?------XX-XX-------o-o-----X?X------------?------?-?-EXXX-?-?--------?----XXX-o?E--
-?E-------XX?X?--XXX-----Eo--oX-Xo--------E-?--X----E?B??------B?X?X-X---?o?--?X----XoXEX-----EXXXo--o---?----X-?o---XX------XoXE-?--------?----XE-X-o?----E-?--------E---X-X------o-----oE?--E--X------
---E----E-XXX-?---Xo---oX-B-E-XX----------o--X-?-----X-X-?------??X-XX----o---oX--XXXXXX--E---XX-XX-?----?---XXX-?--o-X-X-----X-E---??---E-E---?XoX-EEo--------------E--?--X--?-------E?--------?X?-----
------Eo?-XX?XXXoXE----XX-X-XBE?o--E----M---oX--X---X-XX---------X-E-XX--B-ME--oX-?X-?X?-XX-E--X-X??-?-?--XXM-X--------XEB--XX---E-XE---E-------XX---X-?---M---E--??---o-??-XXXE-X-XX?----?-o-o--?X-----
-----?X??-XXXXX-X?X--X-XXX--EX-X??------E-XXXX?E-XX-EX-X-o-?---oXXX-XX-TB---BXX---?--o-XX--XB--MXXMXX-X---X?X-XXX--?-XXB-X--XT--E?X-E?-o------?--X---XX--?------Eo-------X-XXX-X-?XXX?-???--?--X-X----E-
m-o-o|XX---XXMXXXXXXX?-|X-?X-X-X?X-Mo-oXX-X?XXXEooXXX--XXM-----X?|--X--|??oo--X-?oo?X--X|--X-?---XEXXX---?-XX-oXXBEXoXX-XX-XX|o-?X-oX-?----E---BX--E-XXX--|--X--EX|-E-E-X?--X-X--?X--E-o---oM?--Xo-XX?o-
XXXXXXXXXXXXXXXXXXXXXXXXXXXXXXXXXXXXXXXXXXXXXXXXXXXXXXXXXXXXXXXXXXXXXXXXXXXXXXXXXXXXXXXXXXXXXXXXXXXXXXXXXXXXXXXXXXXXXXXXXXXXXXXXXXXXXXXXXXXXXXXXXXXXXXXXXXXXXXXXXXXXXXXXXXXXXXXXXXXXXXXXXXXXXXXXXXXXXXXX
