----------------------------------------------------------------------------------------------------?-------------------------------------------?-------------------------------------------------------
-------------------------------------------------------------------------o------------------------------?-----------------------------------------------------------------------------------------------
----------------------?------------------------------------------------------------E-------------------o------------------------------------------------------------------------------------------------
-----------?-----o--------------------?---------------------------------------------------o-----------------------------------------------------------------------?-------------------------------------
----------------?--o------------------------------------------------------------------------------------------------------E------------------------------o------o---------------------------------------
---------------------------------??-o-----------------E-----??---------------E-?o------------------------------------------------------------------------E---------------?------------------------------
-----------------E-------------?--------------o----------------------------o--------?E------------------------------------------------------------------------------------------------------------------
------------------------?--------------------------?----------------------?--?--------o--------------------------------?----------E-------------o---?----------E--------------------------------?-----?v
---------------------------------------------E-----------?-------------------------?------------------------------?-------------?---------------------------------------------?--?---------------------f
-----------------------------------------------------E--------------------------------------------?---------------------------------------------------------------------------E------------------------f
-----------------------------?----------------------------------?---?---------------------------------------------------------------------?-------E------------------------o-------------?-------------f
-------o---------------E---------o------?-------E----------?---------------------------?-----?--?------------------?------?------------------------------------?------------------?--------------------f
-----E---------------------------------------------------------?-------E-------------------o-----------------------------------------------------------------------E-----------------------------------f
--------------------------?--------------------------------------------------------------------------------?-----------------------------------------------------------------------?-------------------f
m----------------------|----------------|---------------|?-------E--------|--------|-------------o---|-|-------------------------------------|-----------|-|-|--|----|---|-E------------|-------------|X
XXXXXXXXXXXXXXXXXXXXXXXXXXXXXXXXXXXXXXXXXXXXXXXXXXXXXXXXXXXXXXXXXXXXXXXXXXXXXXXXXXXXXXXXXXXXXXXXXXXXXXXXXXXXXXXXXXXXXXXXXXXXXXXXXXXXXXXXXXXXXXXXXXXXXXXXXXXXXXXXXXXXXXXXXXXXXXXXXXXXXXXXXXXXXXXXXXXXXXXX
