--------------------------------------------------------------------------------------------------------------------------------------------------------------------------------------------------------
--------------------------------------------------------------------------------------------------------------------------------------------------------------------------------------------------------
--------------------------------------------------------------------------------------------------------------------------------------------------------------------------------------------------------
--------------------------------------------------------------------------------------------------------------------------------------------------------------------------------------------------------
--------------------------------------------------------------------------------------------------------------------------------------------------------------------------------------------------------
--------------------------------------------------------------------------------------------------------------------------------------------------------------------------------------------------------
--------------------------------------------------------------------------------------------------------------------------------------------------------------------------------------------------------
-------------------------------------------------------------------------------------------------------------------------------------------------------------------------------------------------------v
--------------------------------------------------------------------------------------------------------------------------------------------------------------------------------------------------------
---B-?----------o-?--o---EM--------BE--oo---M-------M-------M-----?------B--oEM---------?---M----BB--o--E----------o?----EE-B-M---BBoB-EM---E------E-----?-----?--------------o--------?-------ET--o----
---Bo--?-----------MB---------o-o?----?----B--M------o------------------oM-----------------?-?-----E----o-----------?---?--M--o------o-M-M-?o------------?--?oE-??-----o----?E-----E--E--M------|?M-ME--
--E----M-----?-T--E---T--E-B-----EE--?----o--E-M----o----MoT?------o-----o--M?---??M-----M---o--E----?-----E--T---MT---BM-----?----?-M--T--B-------------T-M--E---T--E---------M---B-E----------|----?--
----T----T?TT-E|------|---?-----MBE---E??X--E-T-ET-ToE----M|-EB---ToM---E-E-----T---E?-----T---M----?--T----T-|----|T---T--?E------o-o--|-MT---B---?-T---|ME---o-T|-----XEX-BBo-o-T--M--TT-M-o--|--T----
-?-T|?---|M||?-|T-T-M-|MT-TT----T-X---B?-X-XXo|-X|o|E--ME--|TME--T|EMT--TB--TTT-|T---M-TT--|-T--o--T-T-|M-T-|-|-M--||T--|B-oX-TM---T-T-T|EX|--?X--BT-|--T|---B-T-||-TT--XMX--T----|--T--||-?XEE?|T-|----
m--||----|-||--||-|-X-|-|-||----|--X---X-XX-X-|-X|-|-------||----||--|--|---|||-||---XX||--|-|-----|-|-|--|-|-|----|||--|-X-XX|----|-|-||-X|--X----|-|--||-----|-||-||--XX---|----|-X|--||--X---||-|----
XXXXXXXXXXXXXXXXXXXXXXXXXXXXXXXXXXXXXXXXXXXXXXXXXXXXXXXXXXXXXXXXXXXXXXXXXXXXXXXXXXXXXXXXXXXXXXXXXXXXXXXXXXXXXXXXXXXXXXXXXXXXXXXXXXXXXXXXXXXXXXXXXXXXXXXXXXXXXXXXXXXXXXXXXXXXXXXXXXXXXXXXXXXXXXXXXXXXXXXX
