------------------------------?-----------------------------------E----------E-------------------------------???-----------------o----------?----?------------------------------E--------o--------------
--------------------------?-------o-----------?-E-------?---------------------------?-----?--o------------------?--------------------------------------?-----------?---------o--------------------------
-------?----------?-----------------------------------------------------------------------------------------o--o--------------------------------------------------------------E-----E?--------?---------
------------------?-------------------?-----?-------------?--------------?-------------------?-E-----------?--------?---------?---------------E---?----------------------?------------------------------
------------------------?-----o-------------------------?---------------------------?-----------E--------------------------------?----------------?---------o-------------o-----------------------------
--------------------------?--------------?--------?-----------------?-?------------------?---------------------------------?----------?-?------E------?--------------------------??---E---------------?-
----------------------------------------------?-------------oE------o--------------------------o--------?-----------?-----------------------o-----------o--------------E----------------------------E---
-------------------------------------E-------E-------------------------------------------?-?---o--------------o---------------------------------------------------------------o---------------------?--v
-----E--?----------??-----E?--?oE--o?o---------o-----------?--o?-----?--------o---o-o-----E-----?o-------------?---?-------?o-?EE----?-EE---o-----E--?-E------?-o-------o--?-?------?-----EEE--------?--
---o-?---------?----------------------o--?----------?-o-----?--E----E?E----E--oE--E-----?EE-E?------o-----------?-------o----E----o--------------o-----?------?-?-----------E--------E-----?o-o---------
-----?----------o------------------E----------------o-?---------------o-E-??-------?-----E-o----?-------o---------E-E----E-----------??--?--o---o-------------E----?-----?o--------o--??o---?------o--?-
-----o-?--?----E--?-E----o-?---?-E--?--?---?-------------?---o-o---E----------?--?----?-E-------------?-----?-----------o-----?--o?E----EEE---?-----o------o--?-----------o-----o?--------E---?-E--?----
-E----oo-------------?-T?---o---E-----?------------o---?-o--o--?----o--??E----o-----------------?-----------------?o---?--o-----E--------?---E??--E-----??----?---------------|----o-----?---o---?------
----o-----------?-?----|o?--T---?-?--|-E---EEE-TE-TE-?--T-?----?-E-E--E-|T--?-To-T---oE|--E-||----E---|-E-------|?-------?--oo-?---|--------E-E|-------E---o--oET?---|-E------|--------|o|-----|-----E|-
m?o|-|oo|-Eo-||-|?|?--|||-|?|-?E|||||||-|o|||||||||-|-|-|-|---?|--?|E--?|||??E||||-|||||--?|||--o|o?|-|--|o||--E|--?||-|?|--||||--|||--??||---||||-|?||--|-o||?||E|?o||o-|---?|-|-|?|-||-|||---||||?|-|-
XXXXXXXXXXXXXXXXXXXXXXXXXXXXXXXXXXXXXXXXXXXXXXXXXXXXXXXXXXXXXXXXXXXXXXXXXXXXXXXXXXXXXXXXXXXXXXXXXXXXXXXXXXXXXXXXXXXXXXXXXXXXXXXXXXXXXXXXXXXXXXXXXXXXXXXXXXXXXXXXXXXXXXXXXXXXXXXXXXXXXXXXXXXXXXXXXXXXXXXX
