--------------------------------------------------------------------------------------------------------------------------------------------------------------------------------------------------------
----------------------------------------------------E------------E--------o-----E------------------------------------------------M-----------------------------------------------E----------------------
-------E---------------E---------------o--------o----------------------------------------------------------------------------------------------------------?--------------------------------------------
---------------B---------------------------M------------------------------------E--E?-------B------------------E--M---------o-----o------------------E--------------------------------------?---------E-
----?--------------B----------------------?---------------------------------------------------------B-----------------------------------------------------------------M-----------B---------------------
--------------------o-----------B-------------------------?------?------------B----------M--------------B------?-----E-M-------------------------?----------------------------B-------------------o-----
-------B------------------------?--B--B------------------------B--------?---------------------------------------------------------o-----------------------------------------------------------?---------
--o------------------------------------------------------------------------------------------------------o-------------------------------X-----------B--------M----------------------------------------v
---------------------------------------B-----------M----------------E-M----------------------------------E--X----------o---------?--M---X-----------------------------------------------B------X--------
-E--?-----?o--oo--?X-?-oo----X?-------?--------M-XX----?---------X-E??---?-------?--E-----?X?o--?--E-?---o-?-X-XXX-XXX-?--?-XXX-?-X-----X-E----------?-oE-----?-?-?EE?---M--E-?o-E------------??X-X-----
--o-?o--o---?--X?XXX----X----oX-------------?----EX--o----EB------XX-BE--M-----E-o------o-EX-X-X----X----?---X-?XXXXX--?--XX-X--oXX------X---------?E----?E?E--?---X-XE--XX------?--E----------E?X--E---
---------------XX-X----?X?E-XoX?Xo--B-----o----oXX?X-X-?-?--o-o--?XE----------B-?--X----ooXE--Xo---o?XXX?---XX?-X-XXX---?--X--X-XX-?---E-Xo--o--------E---o--------oX-XEXX-XX---?XE------?------X--XX---
--?o---X--?o----X--X-o--oX-MX-oXX--------?-----X-XX-X?E-----------B-E-------E-o-EXX--XoMXX---?X-??-XX--X-----X?BXX?-X--?X?X----XX---XEE--?o?X?-----------E?--o----E--XX?XXX?X---XX-X-X---?o--X??oXE-Xo--
--?o?--X?-X-o---XEXE--M??X--X-XX---??-Eo-----M-X-X-XX--oXXX?TTT---X-T-----T-oX--XXo-T-X-X-?---?X----XX-X-??X---XX-XXo---XX-o-T-?XXX-X??--X-X----EMEoT---X--EET?----X-Xo-XX-X-?-XXE-?X?-XXX-X-XXo-X-o-Xo-
m-?M-?--X-X?-?-XXX------?X---------XE--X--E--X??XX||X-?X-?XX|||?-X?X|--Xo-|-X-X--X--|--X----oXXX-X?XX--X-EXo---X|XX||X--XXX--|?-X|XE-?X-o?X----?--XX|oXXo----|Eo----X--XX--|Xo-|X---XX-oX-X-X-XXXX--X-?-
XXXXXXXXXXXXXXXXXXXXXXXXXXXXXXXXXXXXXXXXXXXXXXXXXXXXXXXXXXXXXXXXXXXXXXXXXXXXXXXXXXXXXXXXXXXXXXXXXXXXXXXXXXXXXXXXXXXXXXXXXXXXXXXXXXXXXXXXXXXXXXXXXXXXXXXXXXXXXXXXXXXXXXXXXXXXXXXXXXXXXXXXXXXXXXXXXXXXXXXX
