-------------------------o-?-------?------------------------E---------?-----------------------------?---------------------------------------------------??----------------------------------------------
------------------------??-E------------------?-E-------------------------------------------------------E------------------------------------------------o---------------------------o-------o--------o-
--E-----E---------------------------------?---------------------------------------E--------------------------------o-------------------------------------E----------?-E?------E------------?----------E-
----o---?------?--------E-?------?-----E----------?--------E-----------E----------o---?----------------------?-----E-------?-----------------------?--------------?-------------------------------------
----E----?--?-------------o----E-------------------------?----E--------------------o------o---------------------------?----------?---------o--------------?--o--?-----------------E----?---?----------o-
----------------------------------------------------------------------------------------------------?----------E----------?----------------------?---o---------E--o------?-----------------o-----?----o-
---------------?--------------?--?----?--------------------------------------------------?---------?--------------E-------------------------------------------------------------------------------------
---------------------o----------------------?-------E----------------??----?-------------------------------------?-------o--------------------------o---------------------?----------------------------v
--?--------E------?------------?-----E----------E---?--o-oo-------o--------------?--------?-------?----?o----o--?-----o-?---?--o--??--oE--E---?----?------?----o--?--------o?-??-------?o--?-E?---------
--------------E--?-o---?o-----?---o-----------------o-------?--o--?----o---?--------------o------------?--E----?--oooo---?----o--E--Eo--------o-E-------?--E-------E---------o-------------?--E-E-----E-
-o-------E--?E--E-----o---?o--?---E----?-------E-?-------E--E---------o--?-----------------?-E--?-E?o-o------o-----E-E------------------E?---------?--o-?------o-----?------------------o-?--------??o--
-o-E-?---?---?-?-----o---------o-----------oE---------o----o-------E--------------E-------------o?E--Eo-------------o-----------?-E-?-----o---?-E--o------??----------o--E--o--o?---------E?------------
-----?-----E-----------?-?----?----?---?---------?-?-?--E-------?--E---------------?--?----E----------?-?-E-?o---------?------------?---?---------------?-o-E--E-----E--o-------o--------??-------------
--o-o-|---EE--E-??-E--------|-?------------|?-?-oE---?-----o-----o----?--------?--?T|-|--?ETT-?|--?TT-----||----|-T-----|--T---|----E----o-To-oT-----?------o----o--T------|-------o--?-o----E?o-?------
m-|--||||-?|-||--?|||--|?||-|--?-?|-?-|?||--?|?--o|||?|--|-||---|-E|?||-|o||?---?E?||-||?o|||-|||||||-|-E-||?||||o|E|o--||E|-|-|-|---?||-||-||-||||?-|o-o?--E-?--|-||-?|---|||?||||-|E|||--|||E-|||--|--
XXXXXXXXXXXXXXXXXXXXXXXXXXXXXXXXXXXXXXXXXXXXXXXXXXXXXXXXXXXXXXXXXXXXXXXXXXXXXXXXXXXXXXXXXXXXXXXXXXXXXXXXXXXXXXXXXXXXXXXXXXXXXXXXXXXXXXXXXXXXXXXXXXXXXXXXXXXXXXXXXXXXXXXXXXXXXXXXXXXXXXXXXXXXXXXXXXXXXXXX
