--------------------------------------------------------------------------------------------------------------------------------------------------------------------------------------------------------
--------------------------------------------------------------------------------------------------------------------------------------------------------------------------------------------------------
--------------------------------------------------------------------------------------------------------------------------------------------------------------------------------------------------------
--------------------------------------------------------------------------------------------------------------------------------------------------------------------------------------------------------
--------------------------------------------------------------------------------------------------------------------------------------------------------------------------------------------------------
--------------------------------------------------------------------------------------------------------------------------------------------------------------------------------------------------------
--------------------------------------------------------------------------------------------------------------------------------------------------------------------------------------------------------
-------------------------------------------------------------------------------------------------------------------------------------------------------------------------------------------------------v
--------------------------------------------------------------------------------------------------------------------------------------------------------------------------------------------------------
-B------------B-Mo--?o-E-?o----oEM-EX----------E--oo----??-----o-B---T----------Eo--?--------E---B?-EB------E-E---M--o-M--M-T--M----o-------------B-B---BM----o----------------------MM-?B-----o--EB----
-M---E----o-?---B----?-------?M--?--X-M-?---T-B--?-T--------BE--M----|E---o-BM---T---M-M-----o-oEEo---------------------B---|--B--B-E--E-o-M-o-------------E---?-oo----B?--M?------------o---BE--B-M----
-----o---M-E---M-EM-TE-------------XX-?-o--?|------|-ET-ET--------X--|--T--?---oM|----M-?--B-----M--------------o---M-T--To-|-E--EE----------M---------o-M--?---------B--o-----E----------M-------M--o--
-T-----------M-T---M|---T-?-MoM-o---X---M---|------|T-|E-|------BMX--|-E|B?ME-T--|-?-o--E---------T-?--X-----o-----EE-|--|--|------o---M-BM----TT------T-o-----T?ET-------?E---?--M--T------Bo-TB--M----
-|M-T-T-M---T-T|-E-B|T-T|oT--B--E-X-X-----BT|T-?--B||?|T-|--T-ET-X-T-|oT|---TE|-o|------T-TB------|-TBX--?-----TT-oT-T|TE|--|-TT--T-----T-T-TB-||-T-T--|-ToT---|--|--oT--T-T--T---?--|-TMT?TT--|TTTM-T--
m|--|-|-----|-||----||-||-|--------X--X----|||-----||-||-|--|--|-X-|-|-||---|-|-X|------|-|-------|-|--XX------||--|-|||-|--|-||--|-----|-|-|-X||-|-|--|-|-|---|--|---|--|-|--|------|-|-|-||--||||--|--
XXXXXXXXXXXXXXXXXXXXXXXXXXXXXXXXXXXXXXXXXXXXXXXXXXXXXXXXXXXXXXXXXXXXXXXXXXXXXXXXXXXXXXXXXXXXXXXXXXXXXXXXXXXXXXXXXXXXXXXXXXXXXXXXXXXXXXXXXXXXXXXXXXXXXXXXXXXXXXXXXXXXXXXXXXXXXXXXXXXXXXXXXXXXXXXXXXXXXXXX
