--------------------------------------------------------------------------------------------------------------------------------------------------------------------------------------------------------
--------------------------------------------------------------------------------------------------------------------------------------------------------------------------------------------------------
--------------------------------------------------------------------------------------------------------------------------------------------------------------------------------------------------------
--------------------------------------------------------------------------------------------------------------------------------------------------------------------------------------------------------
--------------------------------------------------------------------------------------------------------------------------------------------------------------------------------------------------------
--------------------------------------------------------------------------------------------------------------------------------------------------------------------------------------------------------
--------------------------------------------------------------------------------------------------------------------------------------------------------------------------------------------------------
-------------------------------------------------------------------------------------------------------------------------------------------------------------------------------------------------------v
--------------------------------------------------------------------------------------------------------------------------------------------------------------------------------------------------------
--E-o--o--------XX-?-B-------?-M-E--?--E--B-----B?-----o--M----?-B------EB---------------?--B--B---?----MB-------M--?--?E---X-X-E--E---oE-M--oM-------M-B-----T---E-EB--------o-o---B--?-------B---B----
---?M-M--B------X-------E-?--?--B---B----M--B-----------B--B-Eo-------T-XM-----?--------o--------M---B--oE-------E---E------BX--?M?EM?-TE--B-------M-----?----|-----T---E---B-?--------?--------o-o-----
-?-Bo-M-----BX-XT--E-o-E-??-o----oM--M-?--oEM-Moo--B-----o?-Mo--?-EoB-|--XM---B----E--------MB-------ME--------B-----EE-o-?-X----------|--M---o-----------TTX-|---E-|-------?-?E-M-o-E-----BEo?---------
--------T---BXX-|-B-BE---MT-B-To---MTE-----T---T-TT-----B-T-M---B--?-o|-XX------?--TTT-T--T---T-------X-T-B--E--TM--TT-?Eo---X-----M---|B-B--------------M||-X|-----|-?-?--o--B-T---TB-?-?o---E-E---BE--
-E-T-E-o|--E-X--|--ET----?|EE-|-B-T-|T--T-M|--E|-||TT-M-TB|T-oTT-o-T--|--X--EE-T--E|||T|--|-M-|T-?Mo-X--|---T---|-TT||---?-BX-TT--TTM-T|-T--T-X----T-?oT--||-X|TB---|T---T--T---|TT-|oT-TT-T-o?--TTT----
m--|--X-|----X--|---|-X---|---|---|-||--|--|---|-||||---|-||--||---|--|---X--X-|---|||||--|---||----XX--|---|---|-||||-X-----X||--||--||-|--|-X----|--X|--||-X||----||--X|--|---|||-|-|-||-|-----|||----
XXXXXXXXXXXXXXXXXXXXXXXXXXXXXXXXXXXXXXXXXXXXXXXXXXXXXXXXXXXXXXXXXXXXXXXXXXXXXXXXXXXXXXXXXXXXXXXXXXXXXXXXXXXXXXXXXXXXXXXXXXXXXXXXXXXXXXXXXXXXXXXXXXXXXXXXXXXXXXXXXXXXXXXXXXXXXXXXXXXXXXXXXXXXXXXXXXXXXXXX
