--------------------------------------------------------------------------------------------------------------------------------------------------------------------------------------------------------
----------------------------------------------?----------------------------------M-------------------------------------------------------M--------------------------------------------------------------
----------------------------ME-----E--------E--------------------------------------B--B----B------------------------------------------------------------------E--o-----------------------------?---oE---
----------------------------------B---------E-?----------------------------------B-----------------------M----------------------------?-----------------------------------------------------------------
--------------------------------------------------------?-----B------------------------------------E-------------------M---------------------------------------------------------------------------o----
------B-----B---------?-------------------------------o---------------------------------X----------------o--B-------------------B----------o---o--------------?-----B----------------------?------------
---------------?-----------------------------------------M-----------------M----?--M----X-------------------------------o----M------------------------------------------------------------------?--?----
-----------o--------------------------B---------B--------------------------------E------X-M-----------------------------?-----------------------------?------------------------------------------------v
---E-------------------X--------X-------------------------------------X--------X-------X-----------------------------------------------------------------X----------------------XE-X--------------------
-----B---XEo--?--?---XXX?XX-X-XX-XX---??-X--X---?----o-E?-XX--X?EXX-XEX-E-o-X-EoXX-o--XXXXX---XX----Xo--?XXXX-XoX-XX--X-X-----X--?----EXX?XEXo-?X--?o-?XXoo---XXXEXEXE-M?oEE?-XoXXX-o-?----o--X-XX-XXX--
----X--?XX-?-----?EE-XXXX-XXXXXoXX--o---XXXXE-?-E?-E--?X--X-X?-BXXXXXX------EXX-XM--?-?X--X-X--X-X-X---?-X--X-XXXXXX---X-------EE-E--E-?X-XXXX-X--oXoX-XXX-o---XXX-XX--o-XEEE-X-XX--EX-X-XEoXX-XE?XXXX--
----EXXX--------o--E?-XXX?EXoXXEX-o-?--?X-XX-E----oXXEX??X-?X-----X-X---o-----XX-oE--oXXXX--X---XoX--X?-X-E--XX-XXX???-XXX-??-X?o----XXXXXXX-XXX-XXBXE-EX-o--o--XXXX--XXX------M-X--B?X--XE----XXX-XXo--
-----XXXo-o--o-E--?---?XXEX-XXXXXX-?X?--XXXEX--??--X-XX-XBXX----XX---X-o-E---X?-XX--oX--X---XoXX---XXXXBX-Xo--XX-X?----X-XXoXX-MX?---XE-X-X---?oXXXX--XXo-EX--X-XX-X-X-Xo--?--?-XX?-X?XXXoXX--XXXoEXXX--
--E--XX-X-X?XXX---EEE--X--?X-XX--X--XEBo?XX--X-XXX-BXXXX-oX?---X?X-XX?------X-X-XXEXX-XXB-?--XXoX-XoXX-XEX---X-XX-X----XX-XX-M--XoX-X----X-o??-?-X?-X?X-X-oXXXo--XXXX-X---?---X-X-?-XoXXX-X-X??XX?X-----
m-XX?-XXEX-X-X-----BX---?B-EXXE---?X-X-XE-X-XXX-XX--X-Xo-X?XoXX-E-XX-----X??-XX-X--XXXX---X---XXX?XXXXXXXX----XXXX?E---BX--X|X?XXXoXXXXXXXXXX-?E?---X--X--oXXXE-X-X?-XX-XX--?XXX--X-X--XX?XX--XXX-X?XE--
XXXXXXXXXXXXXXXXXXXXXXXXXXXXXXXXXXXXXXXXXXXXXXXXXXXXXXXXXXXXXXXXXXXXXXXXXXXXXXXXXXXXXXXXXXXXXXXXXXXXXXXXXXXXXXXXXXXXXXXXXXXXXXXXXXXXXXXXXXXXXXXXXXXXXXXXXXXXXXXXXXXXXXXXXXXXXXXXXXXXXXXXXXXXXXXXXXXXXXXX
