--------------------------------------------------------------------------------------------------------------------------------------------------------------------------------------------------------
----------------------------------------?--?--------E-----------------------------o-------------B-----------------M-----o----------------o-B------------------------------?-?---------------------------
--------------------------------------------------------o-----------------------------------------------------------------------------------------------------------------------------------------------
--------------------B----------M---------BB--------------------------------------------------------------M-----------------------------E----------------------------------------------M---E-------------
-----M---------?--------o----------------------?---------------------B--------------?---?-----------------------------M---------o---------------B---------------------?-------E-------------------------
-----o---?-----------------------------------------------------------------------------------------B-B---------------------------------------B---------------B----------------------------E------o--E---
--M-----------------?----------------------------------------------------------B-----------------------------o-E---------------------M?-----------B-----------------------------------------------------
-o------E------------?E---?---------------------------?--------------------------------------------E--------------------------------------------------------------M-------------------o--------?-------v
--------M----------------------oE--------------------o---------------------------------------B-?-----o----------------E------------M--M---------------------------------------------?-------------------
------o---BM-B-----o-----Bo----??-B-o---o--oM---o------------?B--E--o-------------------E--o------M?E-?--MME---MMBE-o---oB------o-oM---E---?-?E--M----M?M---B-------B------------?-------oB----B-?-M-M--
----------EB-------------?-?-----?-E----E------MB?MM----E-Eo-oo--o------------------------E---------E--o-E-B-B?----E?---?--oB-------------?E--B----Bo-------oM-?------o----oMB---------oo---?-----------
-----B-?-----------B-??-o?--B---EB---Xo------E--------oMM---?---B--?-B-o---B-o-----B-?---------B-B--------?----o-----------o--o----M-E--E?--E--------o----E-M---------E-E----------o-M-M---B-?E---?-E---
---M----M?-----X?-o---?-----------o---X?-------------M------B-EM-----------B?-M?----B-M-----------EoM-------?---B-o----B--------?--o---o---o----o----BB--ME--MB-B-B---------o------BoB-----o------?--o--
----?--E??---M-X-BX------B---o--?---?X-o-------?E-B-----E-M-o------B--M---?-o--M-?-----B-MM-E?---o----------B--------------M-------XB------------------o--X---M-XX?-----M-----o---------M-E-E-------E---
m-E-XX--o-o-?---XE-X-------------B--X-X---o?oB--B--B---M-----X?----MXM-o----MX----Xo-M|EXX|oXX-B-X--M----B------Mo-M--?----E--o-X--X--X-Eo---M-BM-Xoo-----E---X-XB----?-BM|E-oE-o---Eoo--?-?XB-E--B-----
XXXXXXXXXXXXXXXXXXXXXXXXXXXXXXXXXXXXXXXXXXXXXXXXXXXXXXXXXXXXXXXXXXXXXXXXXXXXXXXXXXXXXXXXXXXXXXXXXXXXXXXXXXXXXXXXXXXXXXXXXXXXXXXXXXXXXXXXXXXXXXXXXXXXXXXXXXXXXXXXXXXXXXXXXXXXXXXXXXXXXXXXXXXXXXXXXXXXXXXX
