-------------o--------------------?-------------------------------?-------E---------o----------------------------Eo----------E------------------o----------------o--------------------------?----?---?--
---------------o--------------------------------E---------------------------o-------E------------------?------------------------------o-?----------?---?-----E-----------?------------------------------
------------------o-------------?----o---------o----------------------------------------E--------------------------?----------------------------------------E-------------------------------------------
----------------------?-------------------------?------?-----?---------------?---?----------------------------E------------------------------------------E-------------?---------------E----E-----------
--------o---------?---?------------------------------?-----------o-----?--E------------------------------------------?----------------?-----------E------------?---------E---?------------------oE------
-------?-------------E---------?-?-------?------------------------------------------------------------------------?-----------?------------------?--------------------------------?--------o------------
----------o------------E-E------------------------?----------------------??----------------------------?----E-?----------------?-------------------------?---------------------?----------?-------------
-------------------E-----?---------------------E-o-------------------o---------------------o---------------?-?------------------------------?------------------E---------------------------------------v
------------?----?----E--------E--o-?-?-?E--E--------?E-?E---o-?----E--------E---E-E?-Eo-------?--?-?----?-------------o-----------?o------?------------------E-----?-o-o-----------?----o?---?-?-?-----
---oE--------E-??---------?o-o-----E-?---E?-----?-----o----?-E--------E--------------o-----Eo--------------E-----------o?--EE--?-?--------o----E---E---E??-----------------?---?-?----?---oE-E--E?-?----
-?E---------------------??-----o-?---E-----Eoo--?------------?------?o-----------EE----o------?-----------??---?o--E-?E-?---------?---E-----o-?---E??--?------o-------E----o-?--E-----E------?-------?--
----------o------?-?-?--?E-----?----?---------??----E-----------?---?----?-----?-o--------------E-------?---------------E-----o-?----?--E-?-?-o--?-------?-----------------------?----o----?---oo-------
--EE---?---?-----?--?--------------------E----E-E----------?--?--|---?---------------E??---?-------------?--E-o--------o---E-E----?---?----o----E--?Eo---------E------o---E-------------------E----?----
--?--o---?---?-?||--|---o-T?-?|-----o---T-|------o-o--|T----|----|T------|---?|||T---o-o---------|o------T?----?---?-----?o----?-|?---o------|--------???---o-o-E--o?--|--ToT---T-?---|---?----|o--?-|--
m|o||||E-|||||||||-?|-|||||||||||-o||--||?o|-|-|?|--|-|||---|-|---|-|?||||?|?||||-||-?||-----||--|||||--||---|||-?o--E||-|?E|o|??|-?-?||---|-||-|--|?|-|-??-|||E||E|--||o-|-|o-||?||?||--|-|-?-|||o--||-
XXXXXXXXXXXXXXXXXXXXXXXXXXXXXXXXXXXXXXXXXXXXXXXXXXXXXXXXXXXXXXXXXXXXXXXXXXXXXXXXXXXXXXXXXXXXXXXXXXXXXXXXXXXXXXXXXXXXXXXXXXXXXXXXXXXXXXXXXXXXXXXXXXXXXXXXXXXXXXXXXXXXXXXXXXXXXXXXXXXXXXXXXXXXXXXXXXXXXXXX
