--------------------------------------------------------------------------------------------------------------------------------------------------------------------------------------------------------
--------------------------------------------------------------------------------------------------------------------------------------------------------------------------------------------------------
--------------------------------------------------------------------------------------------------------------------------------------------------------------------------------------------------------
--------------------------------------------------------------------------------------------------------------------------------------------------------------------------------------------------------
--------------------------------------------------------------------------------------------------------------------------------------------------------------------------------------------------------
--------------------------------------------------------------------------------------------------------------------------------------------------------------------------------------------------------
--------------------------------------------------------------------------------------------------------------------------------------------------------------------------------------------------------
-------------------------------------------------------------------------------------------------------------------------------------------------------------------------------------------------------v
--------------------------------------------------------------------------------------------------------------------------------------------------------------------------------------------------------
-----------?o??X-o-X-Xo?--o--?------------o-E---E-E-?--?o??-X------XE--o---XX------E--X-XXEE---E?----?---X?EX-X??--o-----?--X-E--?-E------o?X-Eo-----------?-----?----------?-------?XX-X----XX------o--
-------------X-XX-X---X----o---?X--XE-E-----E-----?o--E------XE----EXo--?--X----oo--ooEX--X--E-----E------X--XX--?-?---E-?--X-E------E-?--?--X-X---o---?--?----E----E--E----E-------EXXX?--oE-X----?oX--
-o------?E?---XEXX-----X---?-?-?-X--XXXXo----?E-----???-------X-----EX-X---XX-----?---X--XX-??XXE---?------XoXE???o?-----XXX-?--?--------Eo---XE-XX-------------o-------------E-??---X--X-o?---X-?---X--
--?----?-X---E-X?XX-----X-X-?-o-?X-E-XX--?---?----------E-----X---E---X-?--?X-??E----?X---X-?XXX--?-------E-X?X----o?----XXo--------E?-------EoXXXEE-?-----?o-----E---E---?X-----?-XX--X-X-----X--?--X--
-----T----X--?X--Xo-----X-X---?X?X----Xoo-?XX?-----o-----XX--?X-o--oE--X---X--XE--E----X-X--o?X---?----------X--X?--?----X--XX--?--E-------?----X?o--?o-TXX?----?----------X--?--o?-X-?TX----E--X--?X---
m----|X?--EX-XX--X--XX-|?X-X----X---XXo---?|X-?---X-?XX---XXX|X-?---|-Xo-?-X---X-?---o?-XX-EX--X-X-E??-o---EXXE?X|E-E-?X-X-o-X--X---EE--X-X?-??EEX----|E|-XX--XX|-??--oXX-Xo--|XX|E-?X-|XXo-oXXXo?--X---
XXXXXXXXXXXXXXXXXXXXXXXXXXXXXXXXXXXXXXXXXXXXXXXXXXXXXXXXXXXXXXXXXXXXXXXXXXXXXXXXXXXXXXXXXXXXXXXXXXXXXXXXXXXXXXXXXXXXXXXXXXXXXXXXXXXXXXXXXXXXXXXXXXXXXXXXXXXXXXXXXXXXXXXXXXXXXXXXXXXXXXXXXXXXXXXXXXXXXXXX
