--------------------------------------------------------------------------------------------------------------------------------------------------------------------------------------------------------
--------------------------------------------------------------------------------------------------------------------------------------------------------------------------------------------------------
--------------------------------------------------------------------------------------------------------------------------------------------------------------------------------------------------------
--------------------------------------------------------------------------------------------------------------------------------------------------------------------------------------------------------
--------------------------------------------------------------------------------------------------------------------------------------------------------------------------------------------------------
--------------------------------------------------------------------------------------------------------------------------------------------------------------------------------------------------------
--------------------------------------------------------------------------------------------------------------------------------------------------------------------------------------------------------
-------------------------------------------------------------------------------------------------------------------------------------------------------------------------------------------------------v
--------------------------------------------------------------------------------------------------------------------------------------------------------------------------------------------------------
-?-E----XX---??-E-E----?----XXXX---------?E--EE---E-X-----E-XX-X--EE-----X----?E-X--?E-X-X?X-oXX--E-X???----?XX-----X-X-------X?---?--------o?o-XXX--------?--X---X--o---X-X--E--o-o----X-??------o--?--
-o-----X-?XX?-X--?--?------XoXX-?-------?-----------XX----?X?-XE--X-----XX--E---XX-o----X-oXE-X-?--XX--------XX?-o---XE?-E----X?--Xoo------?----X-X-E?----X--E-X-X--------XX----------XX?-?E-?E-?----X--
------X--XX----XX-?E?----E?-X?X----------E--E-o--o---X-----XE?-X--?XX?--?Xo-----X-E?E----XX-EX?X?Eo-X-E-------XX??----XX?---EXoXE-X-------XX?-?E-X--------EX---X?-X--E---XX----------??XoE----?------X--
--??--X-EX?---XX--X-o---?--EXX------?-----?----?--?--X------X-X---?X----X-E------Xo-o-----XXX--X-----XX-E?E-o?X---E----Xo-----XXo-XX----???X--ooXXX-----??-X---oXXE-?---EX-?----X---?-X-X-E-?---??---X--
------X-o?XX--XE-XXX-E--X-X-X-X-----Eo---E-?E-??-X--oX-?----X-X----XXXX-X------?-X--?o-E-XX-oX?X----EX--E-----XX-?---?-X----?XXXX-X----?o--XX-o-XX----X---X-X?-X-X-X?o-?--X-Eo-E-X-EXX-?XXE--XXX-EEX?X--
m-E---X---Xoo??X-XEXX?XEEX---X--o-------XXX-XX?X-X?-E?X???---X--X?-XXX-XX?X-o----?XXo-XXX-XX?X-X---?XXXXo--X-XXX?---E-XX-E---XXX-XXE?-oX---?XX--X--X?--XXXX?X-XXX-X----X-XXEE?-EE-X?-X-X?XX---XXXXXEXX--
XXXXXXXXXXXXXXXXXXXXXXXXXXXXXXXXXXXXXXXXXXXXXXXXXXXXXXXXXXXXXXXXXXXXXXXXXXXXXXXXXXXXXXXXXXXXXXXXXXXXXXXXXXXXXXXXXXXXXXXXXXXXXXXXXXXXXXXXXXXXXXXXXXXXXXXXXXXXXXXXXXXXXXXXXXXXXXXXXXXXXXXXXXXXXXXXXXXXXXXX
