--------------------------------------------------------------------------------------------------------------------------------------------------------------------------------------------------------
----------------------------------------------E------M--E------------------------------------------------------------------------------------------------------?-----------------------------------M----
-------------o------------------------o----------------E------------------------------------------------------------------------------------------E---E-----------------------------o----------M------E-
--------------------o---?-?-?-------------------?------------------------o------------------------------------------M------E-?------------------B--------------------------M-------------------M--------
-----------B----------------------------?---?-----M---------------------------------------M-?------------------------------------------------------------------B----------------------------------------
-----------------M----?---------------M----------------------------------------------------o------------------------------------o------------?--------------------M------------------B------------------
-------?----------------------------------------------------------------o--------------B-----B--------------------------------------------o-----------------------------?---?-----?---------------------
------------------------?------o----------------------------------oB----?--M------------B-----------X---o-----M------?----E----E-----------E-----------------------------------------------------------v
------------------------------------B-----------------------o---------------------------------------XX------------------------------o-------------------------------------------B-------B---------------
--Eoo?----?------?---?----??oo?---?---X-E?-----o-------X-X------o--?X----X-E-E-o?---?---?-B---E-----X-MXX-?E-------?XX---?--?-o---BX?X-X--XXX--XX---------------o------------XX-----o----o----------XX--
----X------?E-----M---------?-----E----X-X----??--E---?-X?---?------Xo--X----?--E?-E--o--?--------?X---X------?---E-Xo-M-------o---EXX-XX-XXX--XX--------?--E?--o---o------oXE-------o------?---??-XX-X-
-??X--E-------------?M--?-?---------o-XXo-E------?--?X-X----B----T--EX-X------X--------?----XoXooo--XXX-----E------?-X-------??--E?o-X-XX-XX----X----------?----E?E---?--EXEX---E----------E---EX---XX--
--XX---B-----?--?---o-----XXX------o--XX--?----o-----X?X?--------|--oX-Xo----X--?---?----E--?XXX?---?XE-o----E--E-?---X-?-----------?-X?X-X?---X?---------BBE??--oX?-o---XXX-------?--X?----Xo--X----B--
--XXXX-----XXX-o-----M---?-X--E-?---MX-X---o--?----?-XEX---?-EX--|--X?XooE-XX?X--T---TT---?E--X---------?-?-X------o--X--??T-----E--E-EX-X?-B---X--T?-Bo--E-E--?---oo-?--XX-B---T-X-E-XX-----X--?X-?-XT-
m--XX-o--X-X|--X-----?X---XX?XX---X-|-X|------o?----||X-o-?X-X------EX?-X----X?-E|--?||XX--XXXX--?-?M--X---?-Xo---X--EXB?-?|XM??-|--E-XXXoXo-X-X-??|X?XBXEX?---X--XXXX-X-XX--?-E|-?X--?---o-XX--oX--X-|-
XXXXXXXXXXXXXXXXXXXXXXXXXXXXXXXXXXXXXXXXXXXXXXXXXXXXXXXXXXXXXXXXXXXXXXXXXXXXXXXXXXXXXXXXXXXXXXXXXXXXXXXXXXXXXXXXXXXXXXXXXXXXXXXXXXXXXXXXXXXXXXXXXXXXXXXXXXXXXXXXXXXXXXXXXXXXXXXXXXXXXXXXXXXXXXXXXXXXXXXX
