--------------------------------------------------------------------------------------------------------------------------------------------------------------------------------------------------------
--------------------------------------------------------------------------------------------------------------------------------------------------------------------------------------------------------
--------------------------------------------------------------------------------------------------------------------------------------------------------------------------------------------------------
--------------------------------------------------------------------------------------------------------------------------------------------------------------------------------------------------------
--------------------------------------------------------------------------------------------------------------------------------------------------------------------------------------------------------
--------------------------------------------------------------------------------------------------------------------------------------------------------------------------------------------------------
--------------------------------------------------------------------------------------------------------------------------------------------------------------------------------------------------------
-------------------------------------------------------------------------------------------------------------------------------------------------------------------------------------------------------v
--------------------------------------------------------------------------------------------------------------------------------------------------------------------------------------------------------
--?--X?--E-----Eo?--o----o--XX---X------------------XX?--??oX--X---??-X-X--------XX-X------o---?------?-o?--?-?---o-X-?----?---oo--?--------XXX---o---E--XXX-----X?-X-E--E-?---o------oo?--?--o--oX--E--
--E--X--o---?---------E-o--oX-?--X----E------------?X----o-X----X----?XX--?X--o?X-XoXX???-----?---XX----E?--?--?--oX--?---??-E----?--------??XE--oo--?-?E-X?--E?--XX---?-Eo---o?---E-----E--------oX-?--
---EX-o--E--X--?-X-o-----?-X----X----------------oX-X-EXX?--XXoXE--?-?XX-XX-----XX--XXX??---------X-?X-----oo-------X?X--T?---------E---o--E-XX---XE-??X-X?---?--o-X----------X-----E-E-E-oE------X-----
-?X-X?XoE---X---o-X-----oXXo-----X-E--T----------X-?-X-X----X-X?o-?--oX-oX-oX--?XE-o-X?-E-?---??-??XoX------XX---?-??XX-E|---------?--XXo--?--XXX?X?---X-XX?o-?--o?X----?Eo--X?X-XX---o----?E----XX--?--
-?X--XXXX-XXE-oXXX------X-XXoX--XE?-?-|-o------X??X?X?--XX?--X?-o--X-XX-X--??XT-X--?-XX?XoXXXXX?--?-X---|----XT-T--oXX-?-|oE----Xo---T-X-----E-XT--X----X--X--?-oXX?o-Eo--E---XXX-X---X--?EX---T-XXX-X--
m-X|-XX-|X-X?-?-X---E--?XoXX|X-X?oX?E-|--E?-?--XXXoX-E---Xo?--X-X-?-XE-XX-|-EX|-X--?X?-X-|X-X-X?X--X??-E|E-E-X|-|?--X-EEE|---o-X?--X-|-?X-X--?X-|--X-E?--X--X?--XX--XXX?--?-o?X|XX?X--oXEXoXE-o|-XX-XX--
XXXXXXXXXXXXXXXXXXXXXXXXXXXXXXXXXXXXXXXXXXXXXXXXXXXXXXXXXXXXXXXXXXXXXXXXXXXXXXXXXXXXXXXXXXXXXXXXXXXXXXXXXXXXXXXXXXXXXXXXXXXXXXXXXXXXXXXXXXXXXXXXXXXXXXXXXXXXXXXXXXXXXXXXXXXXXXXXXXXXXXXXXXXXXXXXXXXXXXXX
