-----------------------B----M---X----------------------------------E--?-----------------------B-B----------------B-Xo--?------------o-B---BB----------E-E-?M------?--------------X?------M---------?----
------------------------------?-----------E-o--o-M-BB---oE-------------------------?----E-------?-o----------------B-B-?-M?----B---------o--------o------B----M------o?----Eo--------o---XBo------------
-B----E--B--------------------M--M----o---X----?--Bo---------------?------------?----E--o-----------M--------------?------------E-B-o----M-------B---B-o----B----M------o--o-----------B-----o----------
--------------------B--X----------------B-M---M-------Eo?---B--B--------X-----------------X--?---o-B-----------B----M-------------M----E----o------M------?-----o--B--B---E---?----?M-----o--E--?--E----
--X-o-----?--E---------------M---B--o--M-----EM------------o-?--B-------------E-----------X-o------MEo-B-----M-----------Bo-------------------------X--?-M-X-B------?----M-----X--------M---------------
--E---X---X------------?----o-------o-----E--M-o---?--------X-X-----M--M-?Xo-----X---M-----------E-XM-----------X--------o----------------o----------o------MM-------E------?----------B--X------?-o--?-
-M-----o-------------B---E-----XB-E--MX--M-E--o-?---M-------M------M-B-----X-----------Eo-----E---------o-----------M-?-----M-o---B----M?---E-o--o-----X----?-----E----------o------M--E--------------M-
-----Mo--oo-----------BME----E-Xo--E-?-E---o---------------X----?--------------o------?------------o-----------M?---------o---------M----B----------M--------M-------M-----------M-------X--B----------v
----B---o---------X--?--o-------XE-------?-----------------------?-----------------------------E---X-E------o-----E------------?---oME----------------E----------?Eo--------------o-?------------B-----f
--------X----M------M---M------E-M-----B------B--E-----------------X-----M?-X-------E--M-------o--M------------------oM--------X-----------------M--------------------B---?-----M----------M?-E-M--E---f
-E---------o--------o----------------o--------B----------B----B---------o---B--------E--E-----------o--B---M-----B-------ooEB---B--E--B----o-M--B-X-------M-----X-----?-------o-?------------o--B------f
---o--o--------oB------oBB------------------------?-E----B-----EM---------------B---M-------------E----XM-----X---B----E-oX-----X-BMo--?---------X--XM-M---E------E------E--?--------------M--------XB-f
----------------E?-------------------M--------------------B---------?-----o-----------------B----------------------o---X-B--------------------o--E-----X-----B--o-X-----------X-------o---------o------f
----E?E-X-o---------M-M-------------------M----------o---o-E------------BE-------------------M-----B------X------------M--------X-----------------------------B----B----E--------E---E-----?B------?-M-f
m---|-----X-B--M-X---E----M-----EM----M---------X--------M---E-E--B-----X-X-----?----BEE-------------------------?-o-----B---------E---E-----o-E--------|---------------o-------E---o------X-----------X
XMXXXXXXXXX-?XXXXXX-XMXXXXXXXXoXXXXBXXXXXXXXMXXMXXX?XXXXXXoXXXXXXXXX?XXMXXXX-X--XXXXBXXXMXXXXXXXXXXXXX-XXXXXXXoX?XXXXMXXXE?X?XXXXXXXXXXXXXXXXBXXXXXXXXXXXXXXBXMXXXXXXXXXXXXXXX-XXXM?BXXXXXXXXXXXXXXXoXXX
