--------------------------------------------------------------------------------------------------------------------------------------------------------------------------------------------------------
----------------------------------E---------------------------------------E------------o----E------------o--------B-----------------------------------------------------------M--?---------Mo-----------
-----------------?M------?------------------o--------------------M-------------------------------------B---E--------------------------------------------------------------------------------------------
---------------------M--o-----------------------------E----------------------------o------------M---------o------------------------------------M---------o----------------------------------------------
-------------------------------------------------------------Eo?-------------------------------E------?---------------E---------B---------------------------?-o--------------?---------o-----M----------
-?-------------------------------------BE---------------------M--------------------------------------?-------M---------B-------------------------------------------------?------------------------------
--------------?------?----------------------------------------------------------------?--------------------------B--------------------------M-----------------------------------------------------------
------o----------------------------------------------E-----------?-----------------------------------------------------M--------------------------B-------------------B-----------B-------------M------v
------------X---------------------------------------------------?---------M--------------o--------------------------------------------------------------o-----?----------------------?---E--------------
-----o----M?X---o?--M--------??M-?o-----E-?-------?-E---E-------o-?------o-EoB-------E----oB----XoBE-?M---?---?----oM-?------E--?-------o--M--BBM-?--XXX---oM---??----M-------ooMo------------oM----oB--
-------------X-E--E-B-----?-------------?o----X--------?--MB------E---B-oEB-M-------oBE-B?EX---o-X-?-------------E--M--o--oE---o----?---?-M---B-oB-E--X-?--E----Mo---o-B-B------M-?M--M-------------o---
------X--B---XM-----E--------?----E--B?-?EE-----E-----B---oM-----E-o-----oM?------?-------X----XX-----?----X-----B---o?---o----?B---o-B-------oBE---oX-E--E---?-B?------o-X--?EM----M-B--o--------M--B--
-E--o-X---o---XE---------?-XX---B---o-X?BE---------E--------E-----M----BEM-M-oXX-M-----o-?-XMXXX---o-B-----X---B--X-Xo?--?--B--?----?--??X---------?-XE---------M-----oo-MX---B----?M----M-?---B--?M-B--
-EM--o-XX-B----X--?----B-X-oX----XXM---B---M?o-M------B---X--M---XXB?--o-X----XX?X-BM---X-X-XXX----M--X---B-X----EXX--X-o-----?--------o--X----E---MX---?X?----X---X--X--X--?---o-o---o--ooo-------M-o--
m|E----XXoooo--oX---M--XX---XX---XX-oBX----X---XM---?-XX-XE-X-X-?-X--E--EoXB--X--X-----B-XE-?X-B-EMB?X--M---EX-?-EEXMX---o--o|------X-EEXX-o---XXE----E-XB-X--XEX-X-X-oX-M--BX-X-X---X?XBX---oX?-?X-M---
XXXXXXXXXXXXXXXXXXXXXXXXXXXXXXXXXXXXXXXXXXXXXXXXXXXXXXXXXXXXXXXXXXXXXXXXXXXXXXXXXXXXXXXXXXXXXXXXXXXXXXXXXXXXXXXXXXXXXXXXXXXXXXXXXXXXXXXXXXXXXXXXXXXXXXXXXXXXXXXXXXXXXXXXXXXXXXXXXXXXXXXXXXXXXXXXXXXXXXXX
