-------------o-?----?-----------------------------E-------------o------------------------------E--?------------E-------?---------------------?-----------------------------?----------------------?-----
----E---------E---------?------------o-------?--?--o-------?---?---------------------E-------?---------?----------E--------------E----?---o-------?------E-----------------?---------o---------------?--
---o-oE-------------------------------------------------------?-----------------------------E-------------?----------------?-?--o------E-------------?-----------------o------------o-------------------
-------?---------------?---------------o---------------------E-----------------?------------------------?--------------------?----E-------------E--------------?------o--------o--o---------------------
----------------------?---E------o-----------------------E?--?----------------------------o------?---------------?----------------------------------------E---------------------------------------------
-------------------?----------------?---------------------------?-----------------E-?-?---------o---E-----?----?--------------?-----------o-----?-----E-----------------E---?------?--?-----------------
----------------------------E--------------------E-----------------------------------------------------?---------------?--?------?----------?-------------------------?------------------------------E--
-------?--------?------------------------------o--------?---------------------------------------------------------?------------------------------------?--------------------------o--------------------v
--------------?-----?----?o?o---o---?-?---?---?-?--E---------?--E----------?E---E-?------E-----E----?o----?----?---------?----??----------?--??E--?--?--??---o?-?------?----o-?-------??o-----?--?-o--?-
---?----------?o--??-?-E-------------o----------------??-------??o??o---E----o--------------?E----?--------o-------?o---o-E----o-------------o----?---?------?E---EE------E---------------?--E?--E------
-?--o------?------------?------?---E--o--------o--?-o--------------------E-?-E?------?--?E-?-E?----?-?-?-?---o---o--------E-------------?Eo------o?--------?-----?-E---o-?-E--?----?--?----------o------
-?--??--?---------------o-----?----?---o--EE?-?-----o---------------E---------?-?--?-------E--------------?---?-?-------o?o?---?-----E-E-?--?--E?--------??--------------EE--E--?--o---?---?o----?-?----
------------??------E-----------------?E-?---o-?---?-?-E--------?----?-------E??-?-?--??---?-------E------------?-------------E---?------?o---E?--------?E----?---?--o?-----??------oo-------?-??-------
-T--|o--o--E-----?-E--?---T----?------ET-|o-E---------?-----------------------|-EE-|E------?----?--|Eo-----o----|--|-----?--o??-E-|----o?-E-oE?-?------E-----|-----------E-------?------------|------E--
m|o||--|--|E--Eo?-o|||E?|||||--||-||-?-||||--||---o|-|-|-|?----||---|E|--?-?-|||?||?E-E||?||o-|??|-|-??|||-|----||----|-|o---||?E||||||||-o-E-||?|-?|?|?-|?|-||---|||?-|?|--|--|--E-?-|E|||o--|---|o||?-
XXXXXXXXXXXXXXXXXXXXXXXXXXXXXXXXXXXXXXXXXXXXXXXXXXXXXXXXXXXXXXXXXXXXXXXXXXXXXXXXXXXXXXXXXXXXXXXXXXXXXXXXXXXXXXXXXXXXXXXXXXXXXXXXXXXXXXXXXXXXXXXXXXXXXXXXXXXXXXXXXXXXXXXXXXXXXXXXXXXXXXXXXXXXXXXXXXXXXXXX
