--------------------------------------------------------------------------------------------------------------------------------------------------------------------------------------------------------
------------?------------------------?----------------------------E----------------------------------------------M------------?--------------------------------------o-B----------------------------E---
-----E----------o------------------------B-------------------------------------------------B------o----------------------?-----------------------------o--------------------------------M?--------------
-----------------------------------------------------------------------------------------------------------------------------o----------------------B---------------------------------------------------
----B--------------------------o---------------------------?---------------------------------?--B-----------------?---------?-------o--------o-----?--?-M-----------------------------------------------
--------------------------o--------------------------------------o---?---------E---------------------------------------------------------?--o--B--------------------------B-----------------------E-----
-----E-----B------B----------------------------E-------?--------------------------------------------?---------------B-----------------------------------------------------------------------------------
----B----------------?-------------------------------------------------------------------------------------------------o-------------------------------------------------------o-----------------------v
--------?------E------------------------------------------------------B-------------------------?------------B------------E----------X-X-------------------------------------------------?E-------------
--B------?-o-----------M-B-----XXB--M--o--o---Eo-----B----BB--X-?o--?-----XXB----?E--------?M--o-----M--------o---B----------B---E---?X------B------?--?-M-B---------M--?-B------------M?B--M-o-E?E-----
----E-?--B--E----M-M-M?---B-M---X-M------------B------o---MX--Xo?---M-E---XX-Eo-----E-------o?E--EE---------B--M---o---?BBEX-X------?X---M--------?---?------?---B---?o-E-------?--------X--------------
---E--o--?----B--B---M?E--------oXMo--oM--BE-M---B-M----B--XXX-B---BE-B?B--XEB------o------------o-o--B-o---B--E--M--B-oB--?X---E---B?X-----B--E-B-------------E-----------E--E---M--ME--X--M-----------
-M-o----o----o---------B-?--?---XB---Bo-o--B-------?--E-B--EX--X---ME?--E--MX---?o---E-o--------o--o-o------B-------?----B-X-?----E--BX--XM--------XE--------??-M----?M---M------B-----oX-?o--BB--------
-o--X--M--MME-E-?-----?---?---?--XX--E--M---E--B--M------B-X---XXoE-X-----B?X------M---XEEX--T--o-------o-----BM-BE----?--X-E-Xo-E-----E-MX----o----X-----XB--M----??-----o--?---XX-EoM-X--X-oE----oB---
m-X-X--X--oXEBX-?---o--o----?-XX-X-X--M---E-X?---X----XBX------X---Xo--o-----X--BoXXM-o-XXX-X|X|X--E------X---X--E-X-M-E-E|X?X--o---?--X-X-------X-XoX?X?X|oXXo--------X---???X---X-E|?XX---XXBX?B-???--
XXXXXXXXXXXXXXXXXXXXXXXXXXXXXXXXXXXXXXXXXXXXXXXXXXXXXXXXXXXXXXXXXXXXXXXXXXXXXXXXXXXXXXXXXXXXXXXXXXXXXXXXXXXXXXXXXXXXXXXXXXXXXXXXXXXXXXXXXXXXXXXXXXXXXXXXXXXXXXXXXXXXXXXXXXXXXXXXXXXXXXXXXXXXXXXXXXXXXXXX
