--------------------------------------------------------------------------------------------------------------------------------------------------------------------------------------------------------
-----------E---------------o-------Bo-------Mo-M---BE----M----??-o---------MB---o-----------E-----M----E--B------B--M---M-B-oo----Mo-------B----------o------B-?-?oM------------o-Bo--------------------
-o-E--?B---o------?-----M-----E----?M-----E-----E---E------------M--o------------------------B---EB-----B------E-----------------------B--?-------B?-B---------?o-----------------M----o--?E------------
-----------?--o--E----?-B-o---------------o-----o--B------o?----B--------M----------o--o----o--------------E--------o-------?-------o-E-------------------------o------?--M------M----------------------
-E------?E?----MBo-BE--BB--?-E-----?-----?E------M?oMo-B----B--?-------M-B-----------E--M-----------------E--o------------------------M----------------------------------EM-B---EB-B-BE-----------------
-o-M?--o-M-----o----------M----B--------Eo-----E--?---------------------E--?--?B----?-----MM--M---?o--B---o---E?-B-B??------------B---?---------------B--o?----Bo------?-B-?-----o------B---B-----------
-----B--------E------M-----M---M------E---------EB----M---------------B----o------E--------Mo-?-------------------------BM----BME--------Bo-?o--M-------------o-o-E--B---?----ME---B?----B?-------------
-?M---M-------B---E-----------B-----o--o-B---Mo---------M-o---?--------M-B--Bo--o-B-----M-----ME--------E-----------?-------o-----?-E------------o?---------XXo--o?------M---o-----------B-o-E---------v
-----Eo----EB-B-----M----?------E---o------?-o?---B--M------------B-?-------------?---------------M--------o--E-?-----o------M--B----------------B-----------X---E-oo-----------------E----M-----------f
---B----E-M---------o------E----?-BoM--M------o--M--EEB-o-?B-MMM--?-----B--?Bo--M?------?--M-E----?E-------?MM??-----o---------?---M-o?-o------E--B---?-------XXMM-----------------E---B--BEMB---------f
----?---MM-------MoB------------o-----E--To-----o-B----M-o----o---M--E-M-MMMB-o?-?--B---E------M-B--E-o-------MoE-o---------M------------M------------------o-X-ooMo-----B-------?-B--M-----B----------f
----?M-B?------EE-----B----?X-TB--?------|----------?X--M-?EM--M?-----------E---Mo------o--?--B-?---?--X--B---|----?--------?--------------ooX-?-BE?-TE-----?BXXX--o-M--------o-o-E----T?---|----------f
-o-------?XM--E-T---B-TEB---EX|--------To|---TB-o|--XXEM----E-MX---TMX--?-X?-M---|E--B---T--BM-oT------XT-----|-o-----B---B-TE-----M------E--X--|----|-----E-T-X--BX-XM---M--o-?o--B-|-|--E-|----------f
----?---M-T---|-TTTo?T|-X-MT-X|-|--Eo-B--|--o|-TX|--XET-ETEX--?--|-|-XM--|-X----?|-ETEM--|---T-T|--|-X|-|B|-TB|-T?TT-|--XTo-|--T-|---X---|?--XTT|--T-|-E---TT|-X-----B|---T--TE-XM---|E|o|-T|----------f
m--|--BX|-|-|-|-|--oX-|-X|-|-MX-|-X|--XBM|-|-|-|o||-XB|--||-X-M|-|-|-X---|-|-E|-M|--|--|-|---|--||-||-|-|-|-|-|-|EX|-|-X-|-X|-X|--|-XX-|-|---M|-X|?|-|oB---|-||-X-|-XX|---|--|--MXX|-|-Xo|-||----------X
XXXXXXXXXXXXXXXXXXXXXXXXXXXXXXXXXXXXXXXXXXXXXXXXXXXXXXXXXXXXXXXXXXXXXXXXXXXXXXXXXXXXXXXXXXXXXXXXXXXXXXXXXXXXXXXXXXXXXXXXXXXXXXXXXXXXXXXXXXXXXXXXXXXXXXXXXXXXXXXXXXXXXXXXXXXXXXXXXXXXXXXXXXXXXXXXXXXXXXXX
