--------------------------------------------------------------------------------------------------------------------------------------------------------------------------------------------------------
-o------------------------M---------------------------------B---------M--------B-E--------------------------------------M-----------------E------------------------------------?------------------------
---------E--------------------------------------------------------------------M--------E----------E-----------------------------------------------------E-----------------------------------------------
-------?------------------------------------------------?---------------------M--------------------o------------------------------------------------------------------M---------------------------------
------------------------------------?---M----o-----M-?--------------------M--E-B-----E-----------------------M-----------------?---------------?--------------------------------------------------------
------E-------------E---------------------------------------o-----------------------------------------M----------------------------------------------------------------------------B---------M----------
------?-----------------------------------------?-----------------------------?------------------------------?----------?-----M----M------------M---?------?--------------------------------------------
---------M-----------------B---------------?------E------------------------------------------------------------o---------------------------------------------------------------------------------------v
----------------------------------------------o----------o----------B------------------------------------B----------------------------------------?-------------------?-M---o----------------------?----
--?--------M--------?---E-M---B------------o-----?-------------M-oM-----o-MM?-o---B-M---------EBM----oME-----M-B-----?-------E-----E-B--M-EBMB--------B------E-o--------oB-----B-E-Eo-E-----E---E--E----
-----o-M------------B-M----M----?-----B---E--E--M--?---------------EB----E-----M-----------------------oM--E----?--EEB----B---M-------B---M--Mo-E-------B--B---------M-------o--o--------------ME--B----
-------------M-o--oo--o------o------------E----M---------?--o----B---?--?----M-------?-----Eo------------------BBEM-E-----E--o---------BE---E------o-----------------E?-E---------M------M--BoE----E----
--?--?-?M---E--------o-X----M-----------M------E------??--?-----B------EM----------E--------oMB----B-----Bo--M----?M-?---M----o------?--EB-----BX?---o---B---B-----?---------??-?-----E----?--?E----MM--
----T-?MB---E-----E-EBMXMX--MM-------X--X---------E--------------??B---E---------E---BB-X--E--X--B-----BXoo---B-?BB-o-B-B----XE-------oE?--?---MX-M-?--BX-------Eo--?-M------------?E-?M----?-------X---
m--X|B-----oB-o-------?MX-XBo-E-o-----X-X-oM---X?-?----X----X---X-Mo-B---M-MM-MX-BX?X-X--o?---X---o----X-----EMB?EX-?E------X--XXX|X-XB?XXXXM--XX?----B-XX?-?--------BMo---ME---E--oB-XXEXE----o--E?-X--
XXXXXXXXXXXXXXXXXXXXXXXXXXXXXXXXXXXXXXXXXXXXXXXXXXXXXXXXXXXXXXXXXXXXXXXXXXXXXXXXXXXXXXXXXXXXXXXXXXXXXXXXXXXXXXXXXXXXXXXXXXXXXXXXXXXXXXXXXXXXXXXXXXXXXXXXXXXXXXXXXXXXXXXXXXXXXXXXXXXXXXXXXXXXXXXXXXXXXXXX
