--------------------------------------------------------------------------------------------------------------------------------------------------------------------------------------------------------
--------------------------------------------------------------------------------------------------------------------------------------------------------------------------------------------------------
--------------------------------------------------------------------------------------------------------------------------------------------------------------------------------------------------------
--------------------------------------------------------------------------------------------------------------------------------------------------------------------------------------------------------
--------------------------------------------------------------------------------------------------------------------------------------------------------------------------------------------------------
--------------------------------------------------------------------------------------------------------------------------------------------------------------------------------------------------------
--------------------------------------------------------------------------------------------------------------------------------------------------------------------------------------------------------
-------------------------------------------------------------------------------------------------------------------------------------------------------------------------------------------------------v
--------------------------------------------------------------------------------------------------------------------------------------------------------------------------------------------------------
---?---?---o--XXoo--XX?-E-?----?---?---?-?-?--XXXX-XX---------o-----------E-oo--?--------X-X---?-----XXX----?ooX--X-oXXX-??-o----?---?-E-?-E??--??---X------------oXX-------?-----E---?-XX------?-------
-----o--?-----X-----X---E--------o----oE--X-oEXXXXXX----?---o------?------X-?----??-?-----X-X--?E-o--XX??---X-XX--X---Xo?X-------------o-----o----ooX-----------?oXXX-----o?--E-?-------X----------o----
--------?-?-?--X-?---X-E?EE?-----?--------?X-X-X?XX?----o------?o--o---?---X?--o-----?---E-X-X??o---XX?---E-?XXXXXX---oXX--?---?----X-o--o-o--?--X?X-------E-----EXX-?---?---X-X??---?X--XX----------E--
----?-E-XX?---XX-E-oXX?--??-E--E--E-E------oX--EXXX---?-E----EXX----oX--X-XX----?------E----X?-------X?-----?XX--X---?-X-----------XX--o-Eo?-E----X-E-E?---?---??XXXE--------oXo--X-XX?--?Xo-T--?-------
--------X?o---X-XX?o-XX-X---?--TT?-----T-----X---XXo-----TT---?X-?T-?X-XXT-X-?T-----E----E--?X--?-T-oXX-o--?X-X--X--E-X--o--E----?-XXX-|-o--X-X-XX--X--T------oT--XX----??---?X?--X-XX?--TX?T|---oE?----
m--?X--X--E--oXXX-?XX-XX|------||----X-|---o-Xo---X-E----||EE--?X-|-oX-X-|-X?-|E---?----?--E--X-X-|XXXX-|-XX-X-|?-X--XX-X--X---|X---X--|XE---XoXX---|X-|---?--X|---XX?XX-----X?-?o-X-X|-?|oX||-Eo-X||X--
XXXXXXXXXXXXXXXXXXXXXXXXXXXXXXXXXXXXXXXXXXXXXXXXXXXXXXXXXXXXXXXXXXXXXXXXXXXXXXXXXXXXXXXXXXXXXXXXXXXXXXXXXXXXXXXXXXXXXXXXXXXXXXXXXXXXXXXXXXXXXXXXXXXXXXXXXXXXXXXXXXXXXXXXXXXXXXXXXXXXXXXXXXXXXXXXXXXXXXXX
