------------------------------------o------?---------------?-----------------------------------------------------------------------------------------?---------------E-----o-----------o----------------
--------------?----------------o-----------------------E----------------------------------------------------------------------?-----------------------------------------o-------------------------------
-----------------------------------------------------E---------------E----------------------------------?-----------------------------------------------------------------------------------------------
---o-----------------------------------------------------------------o-?---------------------------------------------------------------------------------------E------------------------------------?---
----------------------------------------------------------------------------------------------??----o---------------------------------------------------------------------------------------------------
-----------------------------------?---------------------------------?--------------------?----------o--------------------------------------------------------------------------------------------------
------?-------------------------------?---------?------------------------------------E-?-------------------?----------------?-----E----------------?----------------------------------------------------
----------------------------------------E-----------?---------------------o--------------------------------------o----?--------------o-----?-----------------------------------?-----------------------v
------------o-------?-------------------------------?------------------------------------------o----?-----------------o--------------?---------------------------------------?-------------------------f
-E-----------E-----------------?---o----------------o---------------------??--E----E---------------------------------------------o--------------------------------?-------E------o-----------------o---f
------------------o------------------------------------------------------------------------------------------------------------o------------------?----------?---E-------------------------------------f
----------------------------?----------------------------------------o-------------------------------------------?---------------------------------------?------?--------------------------------------f
-------------------------------------E-------------?--------------------------------------------------------------------------------------------E----------------------------?-------------------------f
------------------------------------o------------------------------------?----------------------------------------------------?--------------------??-----------------------------------------?--------f
m---------------X---?X----o--------------?-------X----------------------?------X--X-----X----------------------?-----------------X-----------------------------------------------------X---------------X
XXXXXXXXXXXXXXXXXXXXXXXXXXXXXXXXXXXXXXXXXXXXXXXXXXXXXXXXXXXXXXXXXXXXXXXXXXXXXXXXXXXXXXXXXXXXXXXXXXXXXXXXXXXXXXXXXXXXXXXXXXXXXXXXXXXXXXXXXXXXXXXXXXXXXXXXXXXXXXXXXXXXXXXXXXXXXXXXXXXXXXXXXXXXXXXXXXXXXXXX
