--------------------------------------------------------------------------------------------------------------------------------------------------------------------------------------------------------
--------------------------------------------Eoo---------------------------------------------?----------E--?------------------------E---------?--------------------------------------------------------E-
--?------------------------------------------------------------------------------?----------------------------------------------------------------------------------------------------------------------
----------?------?--------------------------?--------------o--------?--E----E----------------------E-------------------------------------------?-----E-E--------E--------------------o------------------
----------------------------------------------------------------------------------------------------------------------------------------?-o-----------------o----------E--------------------------------
--o------o------o------------------o-------------------o-------------------------------------------------------------------?------------------E---------------------------------------------------------
------------------------------------------------------------------------------------------------------------------?-----?-------------------------?------------------------------------------o-E--------
--?-?-------------------E-----------?----------------E------------E-------------------?--------?------E------------------------------------------------?-----------------------------------------E-----v
-------------------------------o----------------o---------o-----------------E--------------------------------------o------------------------------------------------?E--------------?-------E-----------
-----------o?-----?--??------?--?oo--------?---------------?-E-----E---------o--?-?------?-o?Eo-------?------o------?E?------------------------E----?----------------o-o--?-----------------------E?----
---?--?--?-?---?-------------------?--?--------?E------?-o----------------?--E------E------------------E-?-----?------o----?-?--o--o----E--E-?--------------o-?--------?-?o---------o------?------------
-?--E?--------E-E----E--o-?-?--o?-----o?--------------oE----o--------E------o-------?------------o-----o--E---?o-------?--o?-?--?o-----Eo----------?------?------------?--------oo---?----?E------------
---?-------o---o?-----?-?-?-------?-------------------?--E------E------------E-?-o?E--E--------?E--o---------?--------?T-------E------o-------oo-?------?-----?-------o-----E----------E--?-?---EE------
----------?---?---o?---------oE--E--T---T----o?-?-o--oT-------?-------------T?T-------o--T-?E--?---T---?--E---o---|----|-------------E?--?------oo?-----E---------?--?--------To--?X----TT-----To---T---
mEoX---------E--?|oE?-----------E-|-X?X--o-E---E--|---||----X-------o---o--?|||------?o--|-----E-E-|---Eo-E---E?|-|---?|----E-?------?--E-XX----o||------E?--E?-o---------?EX-|--X--X---||-X-E-|--?-|-X-
XXXX-XXXXXXXX-XXXXXXXXXXXXXXXX?X?XXXXXXXXXXX-XXXXXXXXXX-XX-XXXXXXXXXXXXX-XXXXX-XXXXXXXXXX-XXXXXXXXXXXXXXXXXXXX-XXXXXXX-EXXXXXXXXXXXXXXXXXXXXXXXXXXXXXXXXXXXXXXXXX?XXXXXXXXX-XXX-XXXXXX-XXXXoXXXXXXXXXX-X
