--------------------------------------------------------------------------------------------------------------------------------------------------------------------------------------------------------
----------------------------?---M-----------------------------------o---------------o-------------------M-----------------------------------------M---M-------------------------------------------------
----------M-----M---------------?------------------------------------------------------M-----------------------------------------------------------------?------------------------------------?---------
-----?--M----E--E--------------------o------------------M--------------------o-----------E---------?---------E--------------------------?----------------o-o----------------------------?---------------
--?-------B--E---MM----------------------------------------------------------------------------------B----------------------------o---------------------------------------------B-----------------------
--------------------------------------------E------------E-o------B-------------------E---------------------?----------E--------?-----------------M---------------------E-------------------------------
-----------------------------------------------B------------------------------------?------------------------------------E-------------M-?----------------o--------B--------------------?---------------
------------------M---------------B--------------------------?--------------------------------------------------------------------o-----?-------------------------------------------o------------E-----v
---------------------------M----------------------------------------------------------------?-------E---------------------------B------------------------------E------------------------------------E---
-----M-M--M----?o-E--------B-?o---o----------------?-----B---M------oM----M?-oEE?--o--??--?B--------o?E---B---M------E------EM?Eo-------o-----o--EB-M--?---------EBEM----E--E-M-o----B------E--o---E-B--
----o--B--E--E----E-o-o-o-----B-oE?---Mo-o-MB---Boo-----E-X--B-B---M----B------o-EE--?--?--oE--?o---------o------?-B--------M------------Eo---------E-?--M---B---E----B----------------B--------M-?E----
-----B--oE--B-E--B------EM-----------X--M--E-E-----B-?--EXE--BE---E---M----M-----o-?-----o---?E-------?EM?------?o?B---------o?--o-----?--E-----B-Mo--M-?E-M-?-E---MBE--------B------E------M---??--?---
-EEo---------B-?-?---B?B--M-----------XXXX-B-----E---M--oMX-B-E---------------B--------B--B---B--o-------EM-M-M--Eo---M--B----M-------o-------B-oo------M--B---B--Xo-----M----o-------E----E-?-B--------
-oM-----?----X-EB-----E--?-------------XX-----M----o--M--XoBX--X----M--------o-o-----E?----??-B?B-B-?------X----M---?-E?----ME---E-----o--MB---X?---Bo-E---Xoo----X---?----oB--X--B----X----M---B-o-----
m-X-------?B--X-E-E---E---E-----B-XXoM-oX------oM------o--XX-----?E?MoE---X---------E|EXE?B-?X-B-M----M?-XX-X----X-X-M---M----E-X---o-E--XXo-oXXX--?-X--E-BMXX-----X?-------E--X----B-EX-X-------X--?E--
XXXXXXXXXXXXXXXXXXXXXXXXXXXXXXXXXXXXXXXXXXXXXXXXXXXXXXXXXXXXXXXXXXXXXXXXXXXXXXXXXXXXXXXXXXXXXXXXXXXXXXXXXXXXXXXXXXXXXXXXXXXXXXXXXXXXXXXXXXXXXXXXXXXXXXXXXXXXXXXXXXXXXXXXXXXXXXXXXXXXXXXXXXXXXXXXXXXXXXXX
