--------------------------------------------------------------------------------------------------------------------------------------------------------------------------------------------------------
--------------------------------------------------------------------------------------------------------------------------------------------------------------------------------------------------------
--------------------------------------------------------------------------------------------------------------------------------------------------------------------------------------------------------
--------------------------------------------------------------------------------------------------------------------------------------------------------------------------------------------------------
--------------------------------------------------------------------------------------------------------------------------------------------------------------------------------------------------------
--------------------------------------------------------------------------------------------------------------------------------------------------------------------------------------------------------
--------------------------------------------------------------------------------------------------------------------------------------------------------------------------------------------------------
-------------------------------------------------------------------------------------------------------------------------------------------------------------------------------------------------------v
--------------------------------------------------------------------------------------------------------------------------------------------------------------------------------------------------------
--E---?-----?-----E-?-----?E----?-?------o-X--?--?--o--XXoXoX--X---?XE-Xo?---?--X?XX?o?-----?-------------oE-?--?X?-o-----o?-??---X?o---E--?E?--??-?---?-------oXX-?-o??--E---?----o--------------------
---?--?-------?--o?-Xo-------E---------?-XXX-----X-----?X-X?X--X-?--XX-X-X-?o-EX-?X-X--?----?-------o?---EXXX---X----o--?-X-----?XXX----?---??-----?--EX-----E-XXX-??-?E?--E-?-?--E---?-o---------?--E--
--?----E--X------XXX--?-o--o-oo-?-----o??oX-?----XXXXE-?XX--?XXXX---?XX-?-XXX-X----X??---?----?------E-?-E?X-----X--?----X?-o---?XX----?o--------X-o--Xo---o-?-EX-o---?---o--E--?-o-----?---?----X---E--
-??-T---X-X---o---X----oXX---??------XX-o-X----EX--XE--?EX-?EX??X-Xo--X----XoX----X----oE-XX------------o-XX?-E?--X---??--XX-----X----------------XXXXX--o---o-X-E---?-o-XXX?-XX--------?---?o-XX-------
----|----X--?-?---?X-o---XX-oE--------XX-X--E--XX-oX-?E-XEX?EEXXXXX?XXXXX-X?EXE--?-X----?o-X-X?-EE-X-----X-X--o--X-T---XX?XX----X-?-E?-X---X---oo?-XE?X?--oX---XoX----X---X-Eo-XX----TE---oo-XE-X-?-?---
m---|--oX?----E--EoX--X--X----?E----?||XXE--?---X-X-E|E-XX-EE|-X--X-?X?X--XEX----oX-E-E-|XXXX|-?XXX----|X?-XEE-X-X||-EE-X-XoEE?-X|-?-|X--XX--o-|-X-X?|X-----XX|XoX----|Xo-?XX-XX??---|--?oo|oXX--X--|---
XXXXXXXXXXXXXXXXXXXXXXXXXXXXXXXXXXXXXXXXXXXXXXXXXXXXXXXXXXXXXXXXXXXXXXXXXXXXXXXXXXXXXXXXXXXXXXXXXXXXXXXXXXXXXXXXXXXXXXXXXXXXXXXXXXXXXXXXXXXXXXXXXXXXXXXXXXXXXXXXXXXXXXXXXXXXXXXXXXXXXXXXXXXXXXXXXXXXXXXX
