--------------------------------------------------------------------------------------------------------------------------------------------------------------------------------------------------------
--------o------------------------------------------------?----------------E------E---------E-o----------------?--E---------?-------------E-------------------------------------------------E------------
-------------------------E---------?-E----------?---------------E-----------o--B---B-------------E---------------------------------------------E--------------------------------------------------------
----?-----------------------------------------E-------------o--------------------------B-----B-----------?--?---B----------o-------------------B-----------------M-B------------------------------B-----
------M--------------------------------------------------------------------------------------------------------M--------------------------------------?B--------------------M-?------------B------------
---------------------------------------------------------------------------------o----------?M-----M---------?------------E------B-----------------M------------?--------------------------?------------
------?----------------B----?---E----------o-------------------------------------------------B-----------B-----------------------------------B-------------------------------M---------------M----------
-----------B--------B-------------E--------------------------o----o-o-----------E----------------------------------------------------------------------E--B----------------------------X---------------v
----o-------X----------------------------------------o--o---B--------------------------------------------B-----?-X-------------------------E-M--o---------------------E------------B---X----------------
----MX?---X-X------oXo-oE---?E------?X-?X?XX?oXX--?X-X-?XXoX?Xo----XXXoXX--XXoX--?-?----X--o-X-X?X--?X-XX-o--oXXX-X-o-------?X--EoXX?-----XX-X------E-XXXX-?-o--oo----E?--EEXX--BX?X-XX-X-?-o?----------
-----Xo----X?E-?-?XXXX----?o-E----o-E--XXX-oX-XX-?XoXX---X-XoX-----X-X--X?-X-B---M---?E?X---?-XXX-------XXX???X--Xo?--------XXXXEXX------E-XEX----BE--X?X--o-?----------?--XXo-o-XXXXX---XoEX----Xo-?---
----?X--oE--XE----X-X-XoE?----X--o-X--X?X-?XoE?XXX--X--oBXX-X-X--?-EX---?XXXX--E--E-?-XXEE---E-X?-E------XEX?X-?-XXX--o?---X?XXXXoX-----EXX?M---M-oM-X--XX-X--EE-------o-o--XX?X-X-XXX----X-X-----XXX---
----XXBXXo--X-----XX?-BX-?o-?E-XX?-X---X--XXXoXXXX-X-----XX--Bo--?-XXX?--oXXXMX-?E-----XXXE---XX-EX-E--EXo-XX-E-E?X---?EB--?Xo-X-EXBE?--XX-X---X--M-X?--oXXX---EX-M--?-X----?XXXX---XXX---??XX-ooX-X-X--
--E?MX-X-oEBXXE?-E-X-EX?--?X--XX--XXX-XXX--X---X-XX?E?E-XX-o-X----X---o?E?-XX--X----?----oEoo??X-X-?---X----X-oXXX-------XX----?X-XXX-?X-XXX-MXX--M-XE?-oXX?---X?-X?------E-EX-XXXoXXXXM-E-XXX-XXXXX-X--
m--X?XXo?X?XXXXXX|Xo--XX-XXXooXX--XX--XXXXXXXX-XXXXoXE---X-X-XB-X|X?XXXXX?XX--?X-----M--X-EXE-X-XEX-?-?EX--?EXXXX?X-X-?-?-X-X----X-?XoXXEX--XX?X--XXX-o-X--XXXXXoXX--BE-X?-XXXBXXE-XEXXXX-XX-XXX--X-XX--
XXXXXXXXXXXXXXXXXXXXXXXXXXXXXXXXXXXXXXXXXXXXXXXXXXXXXXXXXXXXXXXXXXXXXXXXXXXXXXXXXXXXXXXXXXXXXXXXXXXXXXXXXXXXXXXXXXXXXXXXXXXXXXXXXXXXXXXXXXXXXXXXXXXXXXXXXXXXXXXXXXXXXXXXXXXXXXXXXXXXXXXXXXXXXXXXXXXXXXXX
