--------------------------------------------------------------------------------------------------------------------------------------------------------------------------------------------------------
--------------------------------------------------------------------------------------------------------------------------------------------------------------------------------------------------------
--------------------------------------------------------------------------------------------------------------------------------------------------------------------------------------------------------
--------------------------------------------------------------------------------------------------------------------------------------------------------------------------------------------------------
--------------------------------------------------------------------------------------------------------------------------------------------------------------------------------------------------------
--------------------------------------------------------------------------------------------------------------------------------------------------------------------------------------------------------
--------------------------------------------------------------------------------------------------------------------------------------------------------------------------------------------------------
-------------------------------------------------------------------------------------------------------------------------------------------------------------------------------------------------------v
--------------------------------------------------------------------------------------------------------------------------------------------------------------------------------------------------------
------X--?-X?----------------E--E-?-----oX-----E?-?o?--?----o-----?------------oo?--oo?----EEE-XXX-E-E?XX-X?------------------------Xo-----X-XXX--------E----?------------XXX---E---??------o--X?----?--
--?----XXX?-X-o--?---------------------?X--?o---------?-----XE----??---?---------?E-E--------XXEXo-Eo---XX--?----E---?----E---------?X?EE?o-X-X--?-?----------?-------o-?-X--X--o--o--o---o?---X---?----
-o-?---XX--X------------?E-o----?-E-----X------?---?------E-?X?-E--E--------ooo---?---E-?-----XoX----EXXX-X---o-?--?--o------X--X?----X----oEXEE------------E-----?----X---XX-------?E?--------XX-X-----
-T-----X--X--?--o---?--E------------E---?XXXX-----o----o---E-X---X?----XX---oXX--?-----X-X--E--XEo---EXXXX--------?---??-?o-?EX-X---XX--?---X-X--?o?-----?-o---X------XX---X?X-----EX------?-?X?-XXE----
-|--?---XXXX----?-TE-----T--T-----o-T?---XXXXo-?-XXX-o--o---X-o-?X?--??XX---?X-E?--EE-XTX-------X----?-X-EXEo-T?-T-?o---?-X---?XE---X-----TT-XXX?-?-----?oT--T--X?oE--XX---XE-XXE--?X-oX-----?-X-X-T?---
m|XE?---?X--XXX-|-|---?X||?E|--??-oo|??-?XX--X--??X-o?-XEX?-X-X-?-Xo--XX?-X-X-EXX---|XX|X-?--?---X-X-?E-X?X--?|--|---??-X-X--XX?o--X--o?--||-XXX|X-?--oo--|Eo|---Xo-o?X-XXE-XX-X?-EEX-EX?E-X-o?-X|?|----
XXXXXXXXXXXXXXXXXXXXXXXXXXXXXXXXXXXXXXXXXXXXXXXXXXXXXXXXXXXXXXXXXXXXXXXXXXXXXXXXXXXXXXXXXXXXXXXXXXXXXXXXXXXXXXXXXXXXXXXXXXXXXXXXXXXXXXXXXXXXXXXXXXXXXXXXXXXXXXXXXXXXXXXXXXXXXXXXXXXXXXXXXXXXXXXXXXXXXXXX
