--------------------------------------------------------------------------------------------------------------------------------------------------------------------------------------------------------
--------------------------------?--------------------------------------?-------------------------?-------------------?-----------------------------o---------?---o--------------------------------------
-------------------------------------------------------?------------------------------------------------------------------------------------------------------------------------------------------------
----------------------------------------------------------------------?------------------------------------------------------E------------------------------------------------------o-------------------
------------o-----?--------------------------------------------------------o---------------------E------------E------------------------------------------o?-----------------?---------------------------
------------------------?--------o------------------------------------------------------------------------------------?---?----------------------------?--------------------------o---------------------
---------------------------------?--------------------?----------------------------------?---------------------------------------E-------?---------------------------------------------?-o--------------
-----------?-----------------o-----------------------------------------?---------------?---------?------E--------------------------------E------E----------------------------?--------o----------------v
---?------------------------------?------------------------?---------------------------------------E-o-------------E------------------------------------------------------------------------------------
-----?-----Eo-o---o---?-E--------?----------?----?o----------?--------o--------?--------------?--o-?-------?-?-??--??-----o---------------o------E--o--?---E--------------E-------Eo?o-----o-o--?-?-E-?-
-------o----------?----?------?-E----o-E-?-EE-o-?---------?----------E-?E-----------o-------o?---?----------------o------?-?--E---E----EE?-----------o-?-------E--E?-?-------------o---EE-?--?E--?------
------?----E-?----??-----------?--E--?-------------?o-o------E--o--??----?-Eo-?------?------------------------------------E---E?-?o--------------?--o-o-?---?--E---------?---?-----EE-----?-?---o?------
-?o-o---?----?T-E-----EE----------?----o--------o-E--------?--Eo---?-?----------T--E--?-E---?o-----?---------EE---E?-?----------?--??-?------o-o-?----?--o--------------------oo------------------E-E---
-------------?|-------T?E--?T---T-o--E|-T----EE--E---------ETE-----?-o---------T|---o------?-o-o--------?T?--o?-------------o--?----?oo-?-?T?--------TTE?--o------??----?----E-T?X---?-----?-TT-|T----E-
m--o?-X----?--o---|-o-|---?-o---|--??-|--o-?--|---?-?o---?--|--E---?----??-E---?|----E---?--?o----o------|---XoE------?X?--o---?o----E-?-E-|-------XX|X----?-------|--------?--|--XX-?--?-?---|o||----X-
XXXXXXXXXXXXXXXXXXX-XXXXXXXXXXXXXX-XXXXXXXXXXXXXXXXXXX-X-XXXXXXXX-XX--XXXXX-XXXXXXXXXXXX-XXXXXXXX-XXXX?XXXXXXXXXXXXXXXXXXXXXXX-XXXXoX-XXXX-XXXXXX--XXXXXXX?XXXXXXXXXXXXXXXXXXXX-XXXX?XXXXXXXXXXXXXXXXXXX
