--------------------------------------------------------------------------------------------------------------------------------------------------------------------------------------------------------
--------------------------------------------------------------------------------------------------------------------------------------------------------------------------------------------------------
--------------------------------------------------------------------------------------------------------------------------------------------------------------------------------------------------------
--------------------------------------------------------------------------------------------------------------------------------------------------------------------------------------------------------
--------------------------------------------------------------------------------------------------------------------------------------------------------------------------------------------------------
--------------------------------------------------------------------------------------------------------------------------------------------------------------------------------------------------------
--------------------------------------------------------------------------------------------------------------------------------------------------------------------------------------------------------
-------------------------------------------------------------------------------------------------------------------------------------------------------------------------------------------------------v
--------------------------------------------------------------------------------------------------------------------------------------------------------------------------------------------------------
-----E--o?---E------o---?------------------B--M-E-M-M---MM-M----?o-?-E--------?------E--?---E-----B-B----B----M--o---B---M-B--M-----X-Xo--E-E-oE-?-BB-----------?------E---?--M--------M--?-------------
--M-?-------o-B--B---------------?--XXoo----o--------?o-EE--------M-o--M---?------ME-o----o----------BE-BE-B-EM----M-----M------Mo-B-X--BE-B-?----o----M-X-M--------M-E-BM----------M---o-EM------------
---o--o-----E-M-o-----------B-------XM----?-BEBM---EoM----B---E-o-----B-------M--BX------B---------T-E-------B--M-------Eo--------XXX--E------E---------X-MB-------?-?BEo--E-M-EMMoM--B-----------------
-M---BT---o-----XX---B-??-?XBE--o---XE-------MXE--?-------o-------MXo--o-?---Mo--MX----o---B-----?-|E-----?M--XB-TXX----E------MT--X-X---E-o--ME?----o-B-X------E----X------E--Eo---?M----B-M-----------
----XE|------T-XXX-?-T----XT-XT----TX-?T-B-T-TX-B-E-T-?-------?-ToX-BXB--TE--TX-EX-TET-T-BT---T-T-?|--ToB-X-TX-XX|-X-T-T-XT-BT--|---XXoTX-oT--EXT---o---oXX-T---TMM-X-TT-TT--T--T--T---o-X-B------------
m--X--|-B--X-|-X-X--B|B--X-|-X|B---|BX-|---|-|-XXXX-|----BX-X-XX|-XX-X--X|---|-XX--|-|-|--|---|-|--|--|---XX|-X-X|-BX|-|-X|--|--|-X--X-|-XX|--XX|------X-X--|---|-BBXX||-||--|B-|--|--B--XBX-B----------
XXXXXXXXXXXXXXXXXXXXXXXXXXXXXXXXXXXXXXXXXXXXXXXXXXXXXXXXXXXXXXXXXXXXXXXXXXXXXXXXXXXXXXXXXXXXXXXXXXXXXXXXXXXXXXXXXXXXXXXXXXXXXXXXXXXXXXXXXXXXXXXXXXXXXXXXXXXXXXXXXXXXXXXXXXXXXXXXXXXXXXXXXXXXXXXXXXXXXXXX
