--------------------------------------------------------------------------------------------------------------------------------------------------------------------------------------------------------
----E-----------------------E--------------------------------E----------------------------------------------------E------------------------B--------------------------o---------E-----------------------
-?------?--------------------------------?------------------E-----M-------------------------------------------------?------------------M----------------------o-----------------------------------------
---M------M----------------------------------B--------------o-------------------------------------------B---------M--------------o--------------------M----------------B---------------------o----------
---M-----o----------------------------M----------o--------B-------------------------------------------E-------------------------------------------o------------B-----------------B---?----------B-------
-B-------------------?-----------------------------------------------------B--------------o-------------------?--------E------o--------------------------------------------------M--M---M-----B---------
-----B---B----------------------------------------------------------------------------E---------------------o---------------o-----------B-----------------------?-----B-----------------E----B----------
---------------------------------------------------------------------------------------------E---------------------M------------------------------------o-?-----------------------------?-----M--------v
--------E--E-------X------------X----------------o-----------X-X---------------?---------------------------E------------o-------------M---o-------------------------------------------------------------
---E-----XX------oEX-o----Eo-----X-XEX--oE-?X?XX--------o----X-Xoo---E--?o?-X-X------M----o-X?XXEE--?----XX?---X-X-EXXo--------?--??o--MEE--?o--------?E------?---o---oM---?o-B-----------X-X-EXEo------
------oEoXX-----?--X-E---?o-?----XX-X-------EXX-------o?-o--X-?----E?---?--o-XXXX-X--?-----X--X------?----XX----X----X---M-?--------o?-----?--Eo-o--?-EX-oX?---E--------?o-oo-E-----?-----X?-X-XX?-?----
---M?-?---XX-?-?-?--XXXo-----E?---XXo?o-o---?X-------o---o---X--?-----o--M?--B-X?X------X-XXX-X-?----------X----XX-XB-?----E-?----?--??---E?-XX--?-o-XXX-X-----E-----------------o--XX?---X-X---X--E??--
--?--o--?-X--o-------X--?oBEo------X-X----?--XX-?-Eo--E-E--E-?--X------???-------E?-o?---X-?XX---o---?-----X--?o-X-X---?--?---oM----o---XXT--oX---oo-XX-X-oo-EXX----------?--------T?X-?E-X-X-oE-XX?oX--
---oT--o-X--E-Xo----X----X--??o-----X-X?TEo--oXX-----XoX--?---XX-??--Eo?B-oE-X-E?XXX----T?XXX-----T---XXo-?XX-?--XXX--E-TE----T?-ToE-X--XX|-E-XM?---X--X--?X--?XE-E--?--EEo--?o-T--|XoX?---XX-?XXX-?oEX-
m-o-|---X--XX-X-X-X-XXX?X?E--Eo----XoXX?|-|--|XX-X--E?X-X-XE-||X--X-XoX?XXX---|X-XX|o--?|-XX-Xo---|X--|XXX|XX|--?-X-XX--||----|--|X?-XXX-X|-X-X-E-?-?X--X?X-XXoX-------o--o--X|-|o-|X-X-E-oX--?|X-?X-|X-
XXXXXXXXXXXXXXXXXXXXXXXXXXXXXXXXXXXXXXXXXXXXXXXXXXXXXXXXXXXXXXXXXXXXXXXXXXXXXXXXXXXXXXXXXXXXXXXXXXXXXXXXXXXXXXXXXXXXXXXXXXXXXXXXXXXXXXXXXXXXXXXXXXXXXXXXXXXXXXXXXXXXXXXXXXXXXXXXXXXXXXXXXXXXXXXXXXXXXXXX
