--------------------------------------------------------------------------------------------------------------------------------------------------------------------------------------------------------
--------------------------------------------------------------------------------------------------------------------------------------------------------------------------------------------------------
--------------------------------------------------------------------------------------------------------------------------------------------------------------------------------------------------------
--------------------------------------------------------------------------------------------------------------------------------------------------------------------------------------------------------
--------------------------------------------------------------------------------------------------------------------------------------------------------------------------------------------------------
--------------------------------------------------------------------------------------------------------------------------------------------------------------------------------------------------------
--------------------------------------------------------------------------------------------------------------------------------------------------------------------------------------------------------
-------------------------------------------------------------------------------------------------------------------------------------------------------------------------------------------------------v
----?--E---------?-----?--??-o--oE--E---?-?E?--------E------?------?--------?--?-----E-?------E----E?---E?-E-?--?-----?--------------------E-?o-?--------?----?-?------?E------?----E-------?----?--o-?-
-------o------?---E-------?-------------------?------------o------?------E------?---E------------------E----o-------?-----E----E-?--??-E------------------E-----?----o--------E------o----o?---o--------
-------?--??E---E?-?-------?-----ooo------------?--?-?E----?------------o----?o-o------------o--E---------o----?-----?-------E--------?--E--?-----?------?------?--E------------?E?---o---o------?---E--
---?--?----------o---o--?--------o--?---------o------?--------?--o-??-E-----o?-E--?-o-E--?E--o---??-o----------------??-------?------------o------------o-----------------?--E--Eoo?-------??-----------
-------o--oo?---E-o?------------??------------EE---------?---------------?--------E----E-E---E--------?------EE-------------------o-o-----E-?--?------o----??----------o---?----o?------E-?-------------
--E------?--------E---?-------o------------?---o-------------E--------o----E?----------o--oo-----o----?--E------------o---o--?-?------E?-----Eo-------E-??----?----?-----------oE---E----------E--------
m--X?XX-E||X|??-|-E||---E--o--?-X-Xo-X-EX-?--|?Xo-?|X?X|--|EXo----|X-o|E-o-X--X-?----X-X|-----X?X-oE-E-X--XXX-?o-----o||X|-?-----X|???XX?X---|--XXE-|E?X-X-|--X---X-|-?-E---X-o|-EX-|X|X-X-X?-X|-oXooXX-
XXXXXXXXXXXXXXXXXXXXXXXXXXXXXXXXXXXXXXXXXXXXXXXXXXXXXXXXXXXXXXXXXXXXXXXXXXXXXXXXXXXXXXXXXXXXXXXXXXXXXXXXXXXXXXXXXXXXXXXXXXXXXXXXXXXXXXXXXXXXXXXXXXXXXXXXXXXXXXXXXXXXXXXXXXXXXXXXXXXXXXXXXXXXXXXXXXXXXXXX
