--------------------------------------------------------------------------------------------------------------------------------------------------------------------------------------------------------
--------------------------------------------------------------------------------------------------------------------------------------------------------------------------------------------------------
--------------------------------------------------------------------------------------------------------------------------------------------------------------------------------------------------------
--------------------------------------------------------------------------------------------------------------------------------------------------------------------------------------------------------
--------------------------------------------------------------------------------------------------------------------------------------------------------------------------------------------------------
--------------------------------------------------------------------------------------------------------------------------------------------------------------------------------------------------------
--------------------------------------------------------------------------------------------------------------------------------------------------------------------------------------------------------
-------------------------------------------------------------------------------------------------------------------------------------------------------------------------------------------------------v
--?-------E--?-o-Eoo---?-E-------E-?----------??----?---E-------E?-o-----o-?---E--oE--E--------o?---?-------E--?---o------------o-------Eo-E------?----E-------o?---?-o--E---o?-Eo---o-------o----------
-------o------o----o------------?-?-----?-------Eo--------?---------EE---------------------?-E--------?-?--?-?-E--??--------?--------E------------?------?---o--?-------?-------?----o?-?--o--?--Eo-----
-?--------?----?--?---?--E-----------?---o-o-------??----?-------E--?E-----E---E??-------o?--E--o-E-o-----------o-o---?----?-----?---------------?--------??---?--??--------------E-E--------o-E--?-----
-E-E-----o----------?--------?---E----------?---?-?------?----??--E-?-?------E--------E----------E----?-?---?-?---o--o-----oo---------------?-----o--------?---?--?---?--?-o---E------E----E---?-----?--
-o--------E?--o--o----------o------?------E----E--?----o-----?-?-o-o-----------?---?---------oo-o-----------------o--?---o-o-?---?-------E---------?-E-----o--?--o-------------o---------E----?------?o-
-----o-E-----o-?----o-----?-o-------------?------------------?--E----?--?-----o-----E----?--o---?--?-??------o-o-------E---o--------------o-o-o?--------??----?E----E--??E---E-----E--------?o----------
mE--X|--X--|-?|X-----XoXEX-X?X?o-X-X?-??-|--Eo|-X-X-|-X-|---XX?E-E|-E-X--E|E-|X-oX---X|X|XXX-?-|?---XXoX|--oXo?--X|EoX-X|-XXo-|-o----E-|--X|-o--X?-XX--X|-X-|--?--?-|XXX--XXoXE|--?o-||-?--?XoXXXE--XX--
XXXXXXXXXXXXXXXXXXXXXXXXXXXXXXXXXXXXXXXXXXXXXXXXXXXXXXXXXXXXXXXXXXXXXXXXXXXXXXXXXXXXXXXXXXXXXXXXXXXXXXXXXXXXXXXXXXXXXXXXXXXXXXXXXXXXXXXXXXXXXXXXXXXXXXXXXXXXXXXXXXXXXXXXXXXXXXXXXXXXXXXXXXXXXXXXXXXXXXXX
