---------------------o------?------------------------------------------?--------E-------------------------------?-----------------------------------------?----------------------------------------?----
--------------------?---------------------------------o----------------------------------------------------o---------------?-----------------------?---------o-----------------------??----?------------
-------------------------------------?--------------------------------------------------------------------------------------?-?--------------------------------------------------------?----------------
--------------------------------------------------------?-o---------------------------------------------------------------------------------------------------?-------------------------------------o---
----------------o---------------?-----------------------------------------------------------o-----------------------o-----------------------------------------------------------------------------------
-?----------------?---------------------------------------------------------------?------?--------------------?-----------------------------------?-----------------------------------------------------
-----------------------------------------E-------?------E--------------------------------------------?------------------------------------------------?-----------E-------------------------------------
----------------------------------------------------?-------------E-------------?-------------------------------------?-o--------?-----E------------------------------o-------------------?----------E-v
-------------------------?-----------------------------o---------------------?----------------------------------------------------?------------o------?---------?--------?-----------------------------f
-------E------?----------?---------?-----------------E------------?--------------?------------E--------------------------------------------------o----------------o------------------------------------f
-----o----------------------------------------------------------o---------------------------------------------------------o--?------o---------------?--------------------------------------------------f
--------------------------E---------------E-----E--------------------------------------------------------------------------------------------E---------?---?-------o-----------------------------------f
----------?---------------E------------------------o--------------------?------------------------------------------------------------------------------------------------------------------------------f
----------?-----E----------------o--------------------------------------------------------------------------------------------?--------------------------?---------------------------------------------f
m---------|--?||---E--o---------------|---------?-------E--|-----------|o--------|---|----|--------?-----------E------|-----------E---|-E-------------|-E-----------|-------o--|----------------|-----|X
XXXXXXXXXXXXXXXXXXXXXXXXXXXXXXXXXXXXXXXXXXXXXXXXXXXXXXXXXXXXXXXXXXXXXXXXXXXXXXXXXXXXXXXXXXXXXXXXXXXXXXXXXXXXXXXXXXXXXXXXXXXXXXXXXXXXXXXXXXXXXXXXXXXXXXXXXXXXXXXXXXXXXXXXXXXXXXXXXXXXXXXXXXXXXXXXXXXXXXXX
