--------------------------------------------------------------------------------------------------------------------------------------------------------------------------------------------------------
--------------------------------------------------------------------------------------------------------------------------------------------------------------------------------------------------------
--------------------------------------------------------------------------------------------------------------------------------------------------------------------------------------------------------
--------------------------------------------------------------------------------------------------------------------------------------------------------------------------------------------------------
--------------------------------------------------------------------------------------------------------------------------------------------------------------------------------------------------------
--------------------------------------------------------------------------------------------------------------------------------------------------------------------------------------------------------
--------------------------------------------------------------------------------------------------------------------------------------------------------------------------------------------------------
-------------------------------------------------------------------------------------------------------------------------------------------------------------------------------------------------------v
--------------------------------------------------------------------------------------------------------------------------------------------------------------------------------------------------------
----?----?---XXE-----E---XX?-XEE-??-------oE?XXXX--XXXX-----E----------??-EX-X------?-XXX--o-?-?---XX---X-o------?XXXE--XXXE?--?-E----?-E-----X--?-o----?o-----X-EX---?------E---XX----?----X-?o--------
--o-?X--?-?--?X--E-----?--XXX----?---?----XX?-XX---XXoX--E-?------?----?-XXX--X----oXXXX----------?XEoEoX-o----o---X-----XoX--?----X-----E---X?---E------------XoXE--------?--o---XXX-XXX---XEX----?-?--
--XXX-----o--XE------E----oX-X--E-Eo-----XEoXEX---?-XXoE--?---------o---E?X?XX-XX--E?XX-----------?X??-X----E-E-o--X----X-X-E-------X----o-o--X--E?----o-X?-o---X-?--o----??-------X-E-X----?X--?---??--
-E-X--?-Eo---X----?--oX-?-X-X-----E-------X--X--?--X-X-X---E-----E--E?---oX--XEXXXX-?X--o-E--?-oE-XXE?XE-?---X----XoEE-??X-X-oEE??-XoX-?-----EX?----?-o-oEXX----XX-----?--E---?---X?o-X-Eo-XX-o--?------
--Xo?----XX?--X?------X-XX---X----?----?---X-X-XE-XXX?-oX-oXXE---------?EXXX-X?-XEX-XXX-XXX-?--X-?-X-Xo--?X-EX----?X----X--?XX?X-XXX??X--X---EXX---X-XX--XXXX-XXX----E-X-X--o--o-oX-X-X?----X---?-XXoo--
m-X?-?--X-X-?-XXXX?-?-?X--X-EX??-?X--?--?--XEX--X-XXX--X-X-XX?----Eo-----X--X--X--X-EX---X-X?X-X----X-XXXX-o-XXX?-X----?XX-XXX-X--X-XXoXX-EX-XX---XXXX----X??X?X?-oE?-X-XXXX-?o?X-XXXX-XXXXX--oE-o-XXX--
XXXXXXXXXXXXXXXXXXXXXXXXXXXXXXXXXXXXXXXXXXXXXXXXXXXXXXXXXXXXXXXXXXXXXXXXXXXXXXXXXXXXXXXXXXXXXXXXXXXXXXXXXXXXXXXXXXXXXXXXXXXXXXXXXXXXXXXXXXXXXXXXXXXXXXXXXXXXXXXXXXXXXXXXXXXXXXXXXXXXXXXXXXXXXXXXXXXXXXXX
