--------------------------------------------------------------------------------------------------------------------------------------------------------------------------------------------------------
-------------------------------------------B--M?------o----B---------------M------E------------E------------------o-----E-----------------E----------------?--------------------------------------------
----M--------E----------------------E---B---------M-----------------------------o----------M---------E---------B------B------E------------E-----E----------------M--------?--E------B-------------------
---------?------------------o-------------------M--o----------------------------------M--------?-------o-------E---------------------------------------?------------------------------------------------
-------------------------------?M----o-----------?----------?--------------------------------------E----------M------o---------------------?----?------?----?-----------B---?--------E------------------
--B-M-----o---M------B---------------------o----?-E-E---E--------o--------M-----------------------------------------------------------------------?----o-----B------------------------------------------
----------------------------------------?--------B----------M---B------------?------------------------E-----------------E----------?E--------E-------B-?--------------------E---------------------------
-----------E----------------------------?B--------------------E---------------------?--------M------?--E------M--?-------------------------?-----------?-------------M---------------------B-----------v
--------------------------?-----------------?----------------------?-?--------E--M-------------------o-------?---------M--------M-----------------------------------B-----B---------------E-------------
----B?-o-------?--?--E----------?--B------M--??---------M--E-----------M----X-------E-E-------E-----B--ME-M-EM?M--o-M--M---oM-?----B---?-BM---?-----o?----------------?---o---M?------E-X?--------------
--o-o----?--E-----?------E------M--?o--?----o----M----M------o--o-X--o-----X--E----B-------ME-X----o--?o---B-----BE--B-----o-----o---E---o---?--o----o-?---E-M---M-o-?-EBEE-----?M------X-?-X-----------
----B--?---?-------------?----M---o-T----?M--------E---E----o------XM-----M-o---T--M--B------XE-o-?E--Eo?-M-----B-----ME?E-M---XM---ToMB--o---EE---B--o----B--M--?-M-----E?--------o----BX--Mo----------
---BE----E----E----T--T----T-o--T--B|--BM---|B---E-E-E------B------X-----ooX?E--|E------o-------E-?-M-E----?----oM-X-Xoo-----EXXX--o|--X--?-M----E-B--------B-B------T------o------M-----oX--X----------
--?T-o--T---o---oE-|--|-T-T|----|-BX|-ET-E-X|----------TM?TX-oo---?EX-TTTTX-MT--|----T-|--Eo-T-T-E--XE|-B-TT-T----T-X----T----XXX--M|-MT|-EM-B-|-o-?-T-MoM----M---?--|TE---T-oX--T-XET--o-XEXX----------
m-X||-XX|B---------|-X|-|o||-XX-||--|--|E|--|-|-||-M|-?|-X|BX-?X-X-X|-|-||-X-||-|-X--|-|---X-|-|-X-XX-|---||-|--XX||-XBX-|-----X----|-X||--X---|---|-|----X----XB-XBX?||-X-|-||-X|--X|--X--XBX----------
XXXXXXXXXXXXXXXXXXXXXXXXXXXXXXXXXXXXXXXXXXXXXXXXXXXXXXXXXXXXXXXXXXXXXXXXXXXXXXXXXXXXXXXXXXXXXXXXXXXXXXXXXXXXXXXXXXXXXXXXXXXXXXXXXXXXXXXXXXXXXXXXXXXXXXXXXXXXXXXXXXXXXXXXXXXXXXXXXXXXXXXXXXXXXXXXXXXXXXXX
