------------o--o-----------------------------------o-----------------E-----E---------------------E------------E-----------?-----------o-------------------------o------------?E-----------------E-------
---------E-?-------------?-----------------------------------------------------E-----------------E--------E--------o-?------------------------------------------------------------------o---------------
-----------------------------?------------------------------?-----------------?----------------------------E------E---------------?--------------------------------?------------------------------------
---------------o-----------------------------------------------------------?--------------------------------------------------------------?--------------?----------------------------------------------
-----------------------o----E-----------------------E--------------------------------------------------?-------------?--o-------o---------------------------------------------?-------------------------
--------E---?--o-------------?-------------E----------------?--?-----------?----------------------------------------o--------------?-----E-----------o?--------------------?----------------------------
------------------E------------------?-----------------------------------------------------------------------------------------------------o--------------?---------------------------------------------
-------?--------E---------------------------------------------------E-----------------?----------------E--?---?-------------------------------?------------------------?---E---------------------------v
------------------------------------------------------------------------------?-------------?-----------------?-------------------------------------------E-----------?------------E-------------------f
----E---------------------------o------------------------------------------------------------------------------o---------?-------?--?------?------o------?------------------------E--------------------f
-------------------------------------?---------?--------------?----------o----------?----------o--------------------------------E------------o--E------------?------------------------?---------?------f
--?--------?---------------o-------------------?----?---------------------------------------------?-----------?---?----?--------?---------------------?E-------------------------------------------?---f
--?--------?-----------E---------------------------?------E---------------------------------------------------------------------------------------?---------------------------------E--------------E---f
---------------------------------------o---------------?--------------------------------------?----------------------------------------------------------------------------------E---------------------f
m-----------------------------------------------------?-?-----o-------------E-X--------------------------------------X--------E----------X-----------------------?--------|--------------X--X---||-----X
XXXXXXXXXXXXXXXXXXXXXXXXXXXXXXXXXXXXXXXXXXXXXXXXXXXXXXXXXXXXXXXXXXXXXXXXXXXXXXXXXXXXXXXXXXXXXXXXXXXXXXXXXXXXXXXXXXXXXXXXXXXXXXXXXXXXXXXXXXXXXXXXXXXXXXXXXXXXXXXXXXXXXXXXXXXXXXXXXXXXXXXXXXXXXXXXXXXXXXXX
