--------------------------------------------------------------------------------------------------------------------------------------------------------------------------------------------------------
-----o--------------------------------------------------------BBo------------o--M------------------M?------------M------------------------E--------o----------B----------B------------------------------
-------------------------o------------------o----------------MM-----M------------------------E-E---------E----------o-------------?------------B---B--------------------------?---------o---------------
------------B----o----------------------B------------?----------E-------------------------------E---B-----M--?------------B--------M----B-----------------------------?-----------M---------------------
------M?----------------------------M-------E-?-----------------BM---?---------------B--------o-----------------------M-------o-----E-------------------------------------------------------------------
----------------------M-----B--------?--o----B--------------B--------M-------?----------------------------------------B---------o---------------M-----------------------------------M----o--------------
------------------------------------------------------------M-------------B---------------------B-----------?--------M--------?-M-----BE-?B---------------------M------------------------?--------------
--o---B------------------o------------?-------------------------------------------------------o-------------------------------o-M---------E----------B--------?-------------------------B--oE----------v
-------EM------?----------------E---------M------------------------B?----------?--------E---------E-----o---------------------------o-------------------------------------B-----------------------------
-------------------M-------M-B---E-o----o----M------E-M----B----E------E?--M--?---E-----E--?-B-B-----------E?-o-E-------------M-M--M--------E-----?--Bo-E---o------B-BB------M----B-E-----oB------------
---MM?-Eo---?--o---------o---Bo--MM?-E--o-BM----B-MX--------ooE-XX-E--o-E?---E--------------?--M?E--M-?E---Eo-------------o--?-------------B----o----------?-----EE-B-M-M-E-------B------o--------------
--B-M---T---------M-B---Bo----X-o?---E---EB---B----X--E--------X-?------M?----o-EB----E---?X---?------E-X-B----M---o---M-------------E-o----------oEEo------?E------B-B----o------?---?---?B------------
---B|--M|-M-oM----XXB---?---ToXB---?--T-T-TM-o?-E-o----M-------XoM------X-?-B-E--?Eo-------Xo--?---ooT---M--|------X----B-MEo---M----M-|----E-------o-|--MT-E-o-----E-X----oM-----BB---B----oB----------
--M-|-Eo|-BXX--X??--To-o----|?To--T---TT|-|----TTXEBo?------M-TXTB-T-TB--XB--Bo--T?o-----XX-E--X--B-T|--MX--|--TE-X|-TTo-TB-M|----?-M--|-|--EE--T-|-X-|-To||-----E--oT-XM?--?|-|-?-?----?--EE|----------
m|--|-XX||-X--XX|---|--||--X|o|--X|---|-|-|----||-XB--X---B--o|-|--|-|--|-X-|--|-|--|-----X-----|---||--X---|-X|-X?|-X|-|||--|----||-BX|-|--B|-B|-|--X|B|-||--X---|--|-X-X--X|-|-XoB-B--X--BX|----------
XXXXXXXXXXXXXXXXXXXXXXXXXXXXXXXXXXXXXXXXXXXXXXXXXXXXXXXXXXXXXXXXXXXXXXXXXXXXXXXXXXXXXXXXXXXXXXXXXXXXXXXXXXXXXXXXXXXXXXXXXXXXXXXXXXXXXXXXXXXXXXXXXXXXXXXXXXXXXXXXXXXXXXXXXXXXXXXXXXXXXXXXXXXXXXXXXXXXXXXX
