--------------------------------------------------------------------------------------------------------------------------------------------------------------------------------------------------------
----------------------------------------------------------------------------------------M------------------------------------------------------B--------------------------------------------------------
-----------------------B------------------o-----------------------------B----M-----------------------------B-----------------oM---------------------E-------------------------?-E-M---------------------
----------------------?-------------------------M-??----------------------------------------------------------o----------------o----------------E-------------------------------------------E-----------
----------------------E---------------E----------------B----------------?-----------------------------------------------------o--B--------------------------------------M--------?---------M----------M-
-----o-------------------------M--------------------------?--------------------------------------------------B--------B---------------------------E-----?--------------------------?--------------------
-------------------------B-------------------------------------o--o----------B-----B-B--------?---------------------M---M-------------------------------------------------------------------------B-----
------o----?---------------------M-----------E-----E-------X-------------------------------------?------------------------------------------------------------------M--------------------------B-------v
-------------------------------------------?---------------X-X-E-X-----X------------------------------?----------X---X---------------B----------?----------------X----------------------------M---------
---?-EX-?-----o-o-M-XoE---oXXX-?-------------XoBXX-E----o--XX?XX--X-E-XX?-X?--Eo-Eo?X------?---XX--X--??oX-XX---?XXX-?XX---?---X-E-EX-?---------Mo-E-?---o--oXX?-EXM--?---B----o?o----?oX------?-----o--
----XXE----EE----?--X?X--o--X?o----?----oE-oX--EX------?----XEX-XX-E---X-ooXX-Xo----XX-----?-X-X-EX-?----XXXo-B-XoX----X--o----XXM---X--B---o----?---?-------XX-XXXo---------o-?------EXo---o?-------o--
-o?--XXo------o---B--XMXBX??X-X---------?-X?EX?XX?--Eo--------X-XX--o-o-XXXXXX---E--X---?-?-Xo-XXX-------?X------X--EE--XX---?E-X----EX----------?------o?E?--XoX-X-X---------o--?-M--XX-XE----?XX---??-
-E---XX------E----T--?-XXX?--XX?-?oXX--?-?-X-X-X-?-----Eo-?o--X--X-------X--X-------XX?---T-Xo-XX-oE--o----XX--E-X-X---XX-----EXE---XX?--?--o------X-X---XX----XoX?X-M--?-?-?---o---?E-XXX---?EXXE--?-X-
--X-oXET-----o----|?-X-EX-?-X-X-MT-X-|o--X-oX--XX-?-?----M-ToX----Xo?----XXXoE?---oE-X-X-T|-BXX|-XE-?---E--EX-?X--XXX-XXoE--|TX-----EX-T--X-?---?XXXX-?--XXX---?-XX|--?--o?--T---B------X|---o--X--?-XB-
m-XX-X-|-?-X-?----|X-|XX---?-X-?||o-X|--X---XEXX?B-?--EE---|-XX-XXX---?X-XX-EX--oo-oXX-MX||B|X-|X?X?--|E---XEXX-E-XEX-XX-oEX|||X---X-?-|-X-?-?--|-X|EXo-M-XX?Xo--XXo-----oX--|?--EXXo?--X|---?XX-----X--
XXXXXXXXXXXXXXXXXXXXXXXXXXXXXXXXXXXXXXXXXXXXXXXXXXXXXXXXXXXXXXXXXXXXXXXXXXXXXXXXXXXXXXXXXXXXXXXXXXXXXXXXXXXXXXXXXXXXXXXXXXXXXXXXXXXXXXXXXXXXXXXXXXXXXXXXXXXXXXXXXXXXXXXXXXXXXXXXXXXXXXXXXXXXXXXXXXXXXXXX
