------?-B-E--E-----E-----------M------------------?----Eo?-----X------------------M-----?--M----M---?------------B?---------------X----------B--E---------------M-------X-----M---------B---------E-----
--?---------E--------------------M-B?-M------X-----------E-----Eo-------M----M---B------B--X-------E------------------EB---------------------X--B------------M---------------------?--------E--M--?--B--
-----------MBXo---X----------M?-----?--B-------M--------------------B------M--?-X----X------o-------X----B-BX---E--------o---E-------------?---------B---------B------M---o------?------o------B--------
-BM-o--o-----------X-------------o---X------B--?-----M---------------E----X---X-----o-------------o-?------B--M---------------X--X------B---------------------?------o----MB----------------M-B-E---?---
----------------------------------?------------oE-------E----?-----E-------XE-E----------------------------?X--------o-----B----------------B----X-------B--?------------M---------M----B----------BB---
--E---M--------------------o-?-B--------------------?----------------B-X---M--------Mo-M----------------?-------B--B-?-----E----XM----B-B------------M?--M--------------------o--M---------?--E----B----
--o----EB------o-----M?-------------------M------------E-------M----------------o--B--------B------?-------X----M--------------Xo-----E---o---?E--E--------M----------?---E--X-------o-B-EMB-E----------
-----------------------------XB------X------------?------o-------------?---B-o-----------E------EX--X--M---------M-M----X-------o------E-X------------B?B---------------EX-M-------o---?---o-BE--------v
-o-M-------o--M---X-------M----M----M--o-E-Boo-------?---E--------------B-M-E------E-----o---XM-----------X--X-----------------E----?o--X-------------------------------M-M-----?------o-oo---M-X-B--E-f
-X----------------------o-------------X------Xo?E-BX?o--E-----B-?-----MX-------X-o---E?---o-o---o---X---------------------o--------------------E---E-------E----X------M-E-M---B-----------------------f
-----------E--M----------?----?----------X---------------------------------o-----------------M-------B-----------------B-----E------X----E-X------EB----------EM--?E---oX----BX----M-----?-----EM------f
-------M-----E--------M-M--------------------o---M------?---o--------------------------E--------M-----o--------E---o-------o----EB--------------M---X----------?--X----------X-M---M-------B?X---------f
----M--------MB-----?-------B----------?-BoEo-----E--Eo--EM-M-o--------M----X?--------------M--o--------o-M---X-EB----o---------------MX---X-X-M--------------E--------E------------------B-M---o----o-f
--M---------o--------B-----XX--------EX---------X--X---B-----B-----------------M------B-ME-----o---o---B-?-E-M--E-?M-M----E--o-----o-E-------?--XB---?------ME-E-??----------?------o----X---?-----o---f
m----B---?-X---XB----oEB--------------|-X-------M--------?--XX-MM--|B---|--X--|----|E--E-----X------o-X|-E------|E-------B------||M--------E------EB------o-------?----M----B---o?--------M-------B----X
XX-XXXMXXXXXXXXoX-XXXXXBXXX?XXMXXXXXXXXXXoXXXXXoXXXXXXXX-BoXXXXXXooXoBXXXXEX?XXE?XXXXXX-XXBMXXXXXXXXXXXXXXXXXXXXXXXXXEXX?XM?XXXXXXXM-XXoMXXXXXXBXXXXXXXXXXXXXXXXXXMXXXMXXXXXXXXX?XXXBXXXXX-X?XXXXXXXXXXX
