--------------------------------------------------------------------------------------------------------------------------------------------------------------------------------------------------------
--------------------------------------------------------------------------------------------------------------------------------------------------------------------------------------------------------
--------------------------------------------------------------------------------------------------------------------------------------------------------------------------------------------------------
--------------------------------------------------------------------------------------------------------------------------------------------------------------------------------------------------------
--------------------------------------------------------------------------------------------------------------------------------------------------------------------------------------------------------
--------------------------------------------------------------------------------------------------------------------------------------------------------------------------------------------------------
--------------------------------------------------------------------------------------------------------------------------------------------------------------------------------------------------------
-------------------------------------------------------------------------------------------------------------------------------------------------------------------------------------------------------v
-?------?--?----E----o--E?--?-?--o-------------?---E---?-?---------------o-EE--?--------E?--o------?--?--------E-------------E?-?-------o------?--E---------?---o-----?E-------?E------E------------?---
-E------o--------------o---E------??------?-o--?-E---?o---o--------------o----?-?------E-oo----?----------------E---------E--------?-----o--------?-?------o-------------o-------E---E---ooo?--?---?----
-------?-?-----E-E-o--------?oo-o--o---------?-?------??----E-?-?---E----?o------------?-o-----o---E-----?-?----------?-o--?-E--------E?-----------E--E----------E?---E?----?-----------?------------E--
---?-?----------?-------------?--E--E----------?--E--o--------?---E-----E-?--------E---E-?------E------oo---?--?---???------------?---o----------?---EE----o-o--E-?E-----------??-----------?--------?E-
----E-?-----o?--?----o--?------------?---EE------------??-----?-??-o-----E-----?---?---o------------?--o------?--?---?-------EE---------------?-?--------------?o---------------o?-?--------?-E-?-----?-
----------?--E--------?--o---E---E-o-??----------?-----o-----o------o--o---E----?--------------------?-------?--E--------?-?--------??E-o----E-o---E?--?--?---?E-E----------?--------o---?------?---?o--
m--X--X-|oX---?-|-X-X-Xo-XX?-XX-E?o--|-|--o-X||?|X----?---o|XXX?X--?o--E-EX-XXoE--X-|E---|?---X|o||E?-----X|X-|?|XX-XX--X?X?---oX--X|X-E-X--XX|X|XX-X-XXX|E-XXX-?----||-?--oXX?|EE-XX-X?oX|--o-oX--|-XX-
XXXXXXXXXXXXXXXXXXXXXXXXXXXXXXXXXXXXXXXXXXXXXXXXXXXXXXXXXXXXXXXXXXXXXXXXXXXXXXXXXXXXXXXXXXXXXXXXXXXXXXXXXXXXXXXXXXXXXXXXXXXXXXXXXXXXXXXXXXXXXXXXXXXXXXXXXXXXXXXXXXXXXXXXXXXXXXXXXXXXXXXXXXXXXXXXXXXXXXXX
