--------------------------------------------------------------------------------------------------------------------------------------------------------------------------------------------------------
---?----------------oM--?-----B-----M--------------o-----E---------E--------------------------------------?----B-----------------------E--B--------------M-------------------------M--------------------
----------------------------o--B-----------------------------------M------------------------------------------o-------------------------------B------------------------o-------M---B-------B------------
-------?------------------------E-B-B-------------------------------------------MB---------?------------M--------------B-----EB----?B--------------------------------o----------------------------------
--------E----o-------------------o------------o-B----o--B---------------------------------------M---------------?-------o----------------?----------------------?--------------------------?------------
-B---------o---------B------E--------------B--------EE-----M?----------E-----------------------?-----------------------B-----------------------------M----------------------B---------M---M-------------
-------------------------------------------E----------M--------Eo--------------------------B-o---------------------B-----------------B?-------B--?---------------------------?-------B------------------
----------------B------------?-----------------------M-----------------------B-E---?----M-------------------------B----?---?-----o---------B------------B--------------------------------M--B----------v
----?----B-------------------?-M---------------------------------M-o----------------------------E--------B----o-----------o----o--------------------E----------------------B?-------------MM-----------f
-?-------------?--------E-?-----T-B--------XXX--B---------B--E----E--E?-?-o----M-?-E-----o----B----B---o--X?-------E-EE--EEB-M----B---BE--oB----E?-----------------?-----M----o?--------M-E-M----------f
---o-----B--E---B?E-E-----?-o--E|----?------X--X-EB---o--?-----M---?BM-M?--o----M--M-?-------M------?-----MX----B--M--M------?---------?E--------------o---------?-M-----?o--?--M---BM------X----------f
-----?---------EEX----??M-----B-|----o----?X--X-o-E?----B--------------B--Mo-?-?----E-----------?-M-E----E-X-Eo?B--?--T-B------?----M-------E----o-------o--------B--ET--M-B----------Bo----X----------f
--------MMEEoMoBX-M-----B-------|M-T?--?-?--XEE--------oM------oB---M----M-M----X-X-?-B--MB---M----EM------X?--BT----oTMX---oM?BMT-M-----M------M--X-----E-Eo----B--T-|-X-M---B---M-----M-TBXT---------f
-E-T|-T?X--oo?--XX-T-----TXo--M-T?-|B-BT---TMXo--T-M--TBE-----X-T---TX----?T--|-X?X?--T--oX?B--E-EXXB-T---XXT-?--TBE|-|BXo-?o---B|-M--?X---T------T-X-TTBo-T-----T?M|-T?T-TX-XX-----TET---|BX|---------f
m-E||-|--X--X----X-|---EB|-X--X-|--|---|---|-X---|--|-|----X---X|---|-XB-X-|--|--X----|----X---XXX-X-M||--X-|----|--|-|-X-XBX---X|-X--XX---|------|-X-||-X-|---X-|-X|-|B|-X-X-X----B|-|---|-X|---------X
XXXXXXXXXXXXXXXXXXXXXXXXXXXXXXXXXXXXXXXXXXXXXXXXXXXXXXXXXXXXXXXXXXXXXXXXXXXXXXXXXXXXXXXXXXXXXXXXXXXXXXXXXXXXXXXXXXXXXXXXXXXXXXXXXXXXXXXXXXXXXXXXXXXXXXXXXXXXXXXXXXXXXXXXXXXXXXXXXXXXXXXXXXXXXXXXXXXXXXXX
