--------------------------------------------------------------------------------------------------------------------------------------------------------------------------------------------------------
-----------------------------------------------------------------------?----?------------------------------------------------------?--------------------------------------?------------------??------?--
-----?-----------------?-------------?--------------------------o----------------------------------------------------------------------------------------o------------------------------------o---------
----------------E----?------------?----------o-o------------------------------------------------------------------------------------------------------o----------------?---------------------------o----
-----------------------?---------------------------------------------------------o--------------------------------------------E?------------------------------------------------------------------------
---------------?--------------------------------------------------------------------------?---------------?-----------------o------------------------o-----?--------------------------------o--E--------
------------------------------------------------o-------------------E-------------------?-----E---------------------------------------?-----------------------------------------------------------------
--------------------------------------?------------------------------------------o---o-----------------?-------E-----------E---------------------------------------------------------------------------v
------------------------------------------------------------------------------------E--------E-------------------?-------------------?-------------o--o-------------------------------------------------
-------------------?----?--?-?------?--o--------?------o--?----??--o--???------o----o--?----o------?--?--o-E-----------------------o-o-E------??-----------o---------o----Eo----o-----------?--o--?-?---
-?-----o-?-----o------E-----E-------------EE?-E--?oo---E-------?-------------?--?o----?-E---oEE----o----?---------o------------?--------------oo------?----?-----E--------?E---E---??----oE---?-o-------
--?---o----??---------?-------------------o--------------?-o-o-------------------------o-?-?----?----o-E------o--??EE-?---------------o----E----E----o-E---?-?--?-------?E-----------------?---?--E--?T-
--E?o--?o----?-------------?----?------?------------E?E--?----o?--?---E---?----------E-----------?---?-----o---------oE?--o-----?-----------E----?-----?--------?---?---?E?--------?--o-------------?-|-
-----o-TE----TE--------E--?-----|--?E------o-oo-o---ToT--------T--------E---?----T--?---------T---o-T---o-?--?------------T--o-?E----o-?---T-------?-oo-E?-----?----o?--E|?-----o----o---?o----E----E-|-
m-E?---|?--o?|------XoE--?Eo?-X-|-XE-------|o---??--|-|-|---?-o|-?-----?-E-?-X-?-|-----E----E-|-X---X--------|---X?-?-?o--|----X---E-E?----|------o-o------X-E--o?---o-??|?E----|--E-?-------------?-E|-
XX-XXXXXXXX-XXXXX-XXXXXX-XXX-X--XXXX-XX-XXX-XXXXXXXXXXXXXoXX-X-XXXXX-X-XXXX-XXXXXXXXXXXXEXXXXXXXXXX-XXX-XXXXX?XXXX-XXXXXXX?--XXXXXXXXX-XXX---X?XXXXXXXoXXXXXXXXX-XXXXXXXX--XXX-XXXXXXXXXXXXXX-XXXX-XXX-X
