--------------------------------------------------------------------------------------------------------------------------------------------------------------------------------------------------------
----------------------------------------------------------------------B----------------------B------------------E-------------------------------------------o-----------M----------------------?--------
------------------------E-----------------------?-------------------------------------o---------------?-----------------------------------------------------------?---------------M---------------------
-E-------------?-------------------?---------------------B--------------------------------------------o--o-------E-E----------o-------------------------------------------------------------------------
--------?------------------------B------------M-------------------------------------------------M-------------------------------------------------------------o-----o--------------o-------------?------
---------------?------------------------------------------E----------------------------?----------?---------------------?--B?---?-----E----?---------------------------o------------------o-------------
--B----------------------------------?B---------o-o------o--------------------M--------------------o----------------------------------M-----M----E---M-E---?----E--------------B-----B------------------
-----------?-o-----------------------E------------------------E-----?---------------------------------B----------------M--------------B---------------M-B-------------------------------B--------------v
-------------------------------------B-------M----------B----X--B-M----------------------M----------------------------M------------------------------------------M---------------E----------------------
---??------B--E---o---------B?-E-E-M--------M--?---?-?Mo---o-BX-XM---M----E--B?B-M-----B---Mo?---------Xo----BE--M-BM--E-?-E---E--?--E--Bo-------B-M?---------------B---B-Eo----E-?--E------?---E-M--X--
--?-X--Eo----------------------o----o----M---o-o----o---?--?--XXX?M-------B--M-M--B--M-M------?--Bo-B--XMo----B--?----?--X-M------o--E--B?-MME?----oX-oooo--------BE?--?M--ME----E-----E-o----------X---
--MBX--------M-----M--E---EX-E-------BB---M----M----?M-M----o--X---?o--M----o--B-B--o----B---o-E---M-?XX-X-------------?XXX--X--E-M--E---?-XXB--BB--XBXB---B------E---B---o-----B--------B--B--E--------
---X------E--?-B-------X--XE-------BEXXX---o-----------?--B--?-X-B--M------BoXo-----o-B--E?EME--E?-X?X-BX-?----B--M------X---Xo-------------X--o----EXX---o-----o----ME-Bo----XEE--oo---EXX--?-?-MB-X---
-oEXo----?-?-o-Eo-----BXB-X-X-X-X-X---XX--X---?------EE------M--XMB------B-MX--E--B--X--EBXBXXXX----X---E--BM--E-------XEX-BXX----------X-BXX-------EX--M---------?Bo-------M?-XX---X--B---M??o--?-M-X--
mMX-X---X-oMXXEX|?-----X-E-EXM-XX-X-XXX--E-X?--X--E---BXM--EB-B-XB-?o--M--oX-E--Mo--X-o--X-oXXXM-X?XXXX----X--Xo-?-E-B--XX?XXXXXX-X--o-EXE-XX--BX-??-X-----X-----B----MBX-M-??-?XXo-X----?X------o---X--
XXXXXXXXXXXXXXXXXXXXXXXXXXXXXXXXXXXXXXXXXXXXXXXXXXXXXXXXXXXXXXXXXXXXXXXXXXXXXXXXXXXXXXXXXXXXXXXXXXXXXXXXXXXXXXXXXXXXXXXXXXXXXXXXXXXXXXXXXXXXXXXXXXXXXXXXXXXXXXXXXXXXXXXXXXXXXXXXXXXXXXXXXXXXXXXXXXXXXXXX
