--TB?-B|EXo-T-|---E---XTTo--BEXXo-oX-E|XEMMM|T-M?-------XBX-TE--T---EB-oE-B-XX-MX--M?---|-?-X--o--B-?M-B?M-M--B-?-E----X-XBM-?B-X-X-B---XB----|X?B-M--?M--E-?-o---E?---TXB-oM|-E?B?-|?-E-T---Mo-?XToE---
---ETMo?--XE?X--ME----|-----o-oMM-BT---?Boo-o-|ET-B-TMXXETM----M?----T---BXEX---?-EB|?-E-T--MXoBETT-B-o-|--oE|X-T|X|-E--EBo--o?X-B--EMoMBTEM---M-ETE-T-TT?-M-M|Mo---T-T|BoTTT---T-||BM?----M-T?--T|-?---
--E-MTooEoB|-B-|X---B-----MTo|X-|-E--------|-o-|--?T--T?XE-EMT--X-T|?EBT-X?--oE-M---To-oB---BTME---B|XMX?-B----Bo???T-oE--o---M-----o?|MBoT|X-----XB--EMX-MM--|--ET--|-B---B-X-B---M|X-|M-MTB-|-??M-XT--
--X-o|-o-XE--E--BToXBo--||---oX-B-|E-?-XB-T-----?----EMB-M-?--Bo--M--?--XEXX-B------?BE-------?|oB--?o-B|B-MBo--X-E-TM||-T?B---XMB--MM-X|E?T---TBX-EE-o-TBB---?-E|TM---?---E|--T---E--?o|--???M-o--E-XX-
--?-XX|---EETE-T-M?TTT-BM|EX?M?--MMToB---ET-T-----?M-M-o|--TBEB|o??B?---?o|X-o---?o-B?--B?|M--EXM|--|------MX?M|?-EXMMB-TM----XX-?o-B--|MX-XEo-|--ET?|XEB-E|----|To-?TM----X-o--EX-||-TXE-E-ETo-?BBBE|E-
--oX---Bo|--B-||--o---o-?oM?-o--?ET--XME--XM--T----B--EEBo?--Xo|MTB-T-|oEEB|----E-B-E-X--X-E|---E-B--T-E--o|oM-o-|T-B-??B--X----X?-XT--o-MXM|----TM|B|oB-o--Xo?--BM-EBB-E|MoT?|-ETB--||-MXT-?T-----XE---
---B|XE|--E?X?---BX-XX-MEE-EB--TEE-MMo----B---X-XoT---EE|T?-XXMB-Bo-MoM-o----o----T?X-E---|E----BB-|ET--|--|-?T-|-?E-ooX-o--|-X-TT-M?o-?-|E--|---M-M-X--M-E-T?TE--?--BM-XEX--TT-EBE-B-----?-X|-ME-BoB-|-
-EoEoX---T--||-TEBBX--T--TM-BX|E---oE?-T---BBM-?--T--o---ME|X-o-?-X|ME|-|MB-?|??-MX-oE---MX-TTBTo?--E|M--X?----oB--E-T?----ME------M?--o|-o-oE--||-|XMo--?B--M---T--MM-|?-B--TX?o-B-ETT-?M-|-BB---||--Ev
--TM-X|BEBB-XT--oE-?---?XMMT|--X---|-T-XEB|XT-?oo---To---T|--M?-BMBT-|-|-BXEE-???XXoB----T-B---X-?-o|XM-B-X||EE|TE-E-X--?-M-BE-|---?-|-?--oET-EEE---|--T-T?-T-E--?|TX---X--MTo-|--XMT--TBo-|--T?o-X----f
--oE-MT-----|-M-BM----E-|B-o-X|??o----T|oT-|Bo-?E--?--B-M-T?--MooT?-o?----oE-?--oB--TB-BXB--?---|B-Eo-o-T|-T?XB|-ME?-oBM-oX-----Xo----o-----??TEBE??--|?---?ooT|M-B|-?-EMo-oo--|------B-?M-?T-----Mo-XTf
---|-B--M-|MoE|XM-Mo|------?-B---X--o?---M|X--T-?---TE?M--Mo??--E--Mo--E--ME---?-----M---|---X-XT-T-o-|o-o-oBToEEEXT-E|----E-TB-|---B-oX---X--?Mo-EET---MTM-MTBB--?-To|||?-BoX|ETB---E--o-?---X---TX-B-f
-T?X-BE--E-X?BEE----EBT-T-X---o---MB|M--M-M--|-oE-o-oEoo-?XET-----M-BM-MM---|oET?oBBE?--?-E--B-TX--|?ooT??--Mo----E----X|XBM--ooX---?MB--M-oo|ME-X?M|oEo?-||-M?---MEE|EMXTE-M---E--MTXM-BEo|B-E----|-E-f
-EBTX-oE|XMTB-|E--o-?X--T-E--M----T-|T-EEX--|--?---o|------X---X-MM---B-?-|BXoo?-|----oo-XX--E---BE?--E-Bo-oM--?T-|BX|??--B--||oX-BMXXM?--Xo-?-|o----B-MT-B-o-X--BEE-M?ET-|M|T-oMEEX-T-T?-T?---Too-X-o-f
--oX-?--?|XB||---oE-MM-oT-EMEE?Mo|-----B-|?B-Xo|Eo--Mo-M??|-?-E??|-----EMXT--X-oT--X--X---M|--TME-MB-T--MB|oM-T--?-T-T-oX-Xo-?|o-XM-?B?-?oM-B-T-ToBEEoMo--M-o-T-X-TXEBX?TBE--EoX-XTMX-o---oEo--o-?TToB-f
m---oToM|-Mo---EM--oTX-T---XTEB-?-?-T--EoEXXo-B---B-TEo--|EB-|-TB-T--|-E---B|-X--E|X-X||--T---M-E-E--EM---?-T--T----T?-X---M--o-T--X-XMMo-oB|?----X|o-oXEM-BoMM-|--o-E----??-?T-B-oE--oM?-o-T---XBE----X
XXXXXXXXXXXXXXXXXXXXXXXXXXXXXXXXXXXXXXXXXXXXXXXXXXXXXXXXXXXXXXXXXXXXXXXXXXXXXXXXXXXXXXXXXXXXXXXXXXXXXXXXXXXXXXXXXXXXXXXXXXXXXXXXXXXXXXXXXXXXXXXXXXXXXXXXXXXXXXXXXXXXXXXXXXXXXXXXXXXXXXXXXXXXXXXXXXXXXXXX
