--------------------------------------------------------------------------------------------------------------------------------------------------------------------------------------------------------
-----------M------------M---M---------------MM------o------E--o--------------M------------M--B--------------------------------------------o---B-----------?------B--------------------------------------
-------?----------?----------------------E--?---E--------------------------E----------------------------?--------------------------------------------o---?----------------E----E----M-------------------
--------------?oM-------------------------------------E-------------------------E----------------------------------------------------------------------------------------B----E--E----------------------
------------BM--------------------------B----M---------------B------------?---------B--o-------?------------------M--------------------------------------------o-----------M-o-?------B-----------------
----------E------------------?--BE-------------------------?E-----------------E-------------?----------B------------------?---BM---------?-----------o-----------o------------?-------------------------
-------B-E----------B------------M-----o--?-----o-------------o--o--------------------------------------E-----------------?----------------------?MB----------------------------Bo------E--B------------
-----o----------?---------------------------?-------------------------E--------?M------------o--------------M--------------------o-------B-----?----------------B---?----------------------------------v
--E------------??-----------------?------------------?--------B------E---------------------E-?--E--------M-------------------------------M----M---------------------------------------------------------
---E-M-?----o-----?E---------------X-------------E-------B-o------?--o-E-------?--?B--M----X?-BE---?---E--?--E--o?-------?-o-o----M-----B---o--MB?B---E?----------oE-------M-----------BE-BE------------
-----E--------X----B----------E--XXoo-----B----B-?-----?-E-o-M---o------M--B----E----o---B-EX-X----E---------?---EM----oM-EM---B-X-XXX-B-B---BB----E-B--B----M-------o----o?--MM----B-------------------
---M-B-----o---XXo---?-------E----X-----oM-E-----E-----o--?-------E----?---E-MBX---Bo-------TXX-o------oo-E--?-?M-M?--Xo-o--------X-X-T-B---B----?--o-E--E-------XEoE--o---M--M---MBM-E-B-?--M----------
----oB--TE|---BTX-X-M-E----E----X-X-EM-EB|--BBXoEo-E-T-E--MEo-B-----|------?---X-|---------TTMX-----o-----o------M----X-o---??-----X--|-----?TBoTX-X-o-M---?--EMX-E--o-----M-E-|-E?-|-B--E--------------
--B-T---|M|----|-X-M-TB-T----XTX---?-MM--|---X--M?-T-|-M-T-o-T-T-T--|E-?T--X-M-XT|-ToMET--X||-?XT-?-T-?-TE-TM-T--TT--XT-TBo-o-o--o--XT|-M-BX-|--|-X--T---T-?-?BX-|----TTT-M--M-|M--B|--EoTTE-T----------
m---|-EX|-|?B|-|-XX--|-X|-||-X|-X|--X-oXX|---X|----|-|-X-|-BM|-|-|-X|-X-|-X-B-X-||E|---|-|-?|-XX|---|---|-B|--||-||--X|-|--B------X-X||----X-|--|-X--|--X|-|--X-X|-|---||----X-|--?X|-----|--|----------
XXXXXXXXXXXXXXXXXXXXXXXXXXXXXXXXXXXXXXXXXXXXXXXXXXXXXXXXXXXXXXXXXXXXXXXXXXXXXXXXXXXXXXXXXXXXXXXXXXXXXXXXXXXXXXXXXXXXXXXXXXXXXXXXXXXXXXXXXXXXXXXXXXXXXXXXXXXXXXXXXXXXXXXXXXXXXXXXXXXXXXXXXXXXXXXXXXXXXXXX
