--------------------------------------------------------E-----?-------------------------------?------------------------------------------------?-------------------?--------o---------------------------
-------------------------------------------------------------------------------------------E-------------------------------------------------------------o-o--------------------------------------------
------?------------------------------------E---------------?-----------------------o----------------------?------------------------------------------E--------?-----------------------------------------
--------E-------------------E-----------------------------o--------E--------E--------------------?--------------?----------------o----------?---?-------------------------------------------------------
---------------------------------------------------------o-------------------------------------------------------------------------E-----E--------------------E---?-------------------------------------
---------------------------------?---------------------?----------------------------------------------------------------------------------o-------------------------------------------------E-----?-----
-------------------------E------------------o---------------o--------------------------------------o--------?-----------------------------------------------------E----------E------------------o-------
---?---------?-----------?------------------------------o------------------------------------?------------?E--------------------?------------------------?E-E---?----------------------------?---------v
-----------------------------------------------------?-----------------------------E-------------------------------------------------------------------------------------------------------------------f
--------?-----E--------------?---------------------------------------------------------o---------------?---------------------------------------------------------------------------E-------------------f
-----------------------------------------------------------------------------------?------------------------------------------------------o-----------?---------------------------E--------------------f
--------------------------------------------------------E----?-----------------------------------------------------------------------------------------------------------------------------------------f
----------------?-------------------?------------------?---E------------?-------------------------------------------------------------------------------E--------------------------------------?-?-----f
--------?------------------------------------------------------------------------------?----------------------------------?----------------------------------------------------------------E----------of
m----|---|----------|--?------------------------|-|-------------------------|------------|-----?----E------------|------------------|---?--------------|E-----------|--|----------|----|---------------X
XXXXXXXXXXXXXXXXXXXXXXXXXXXXXXXXXXXXXXXXXXXXXXXXXXXXXXXXXXXXXXXXXXXXXXXXXXXXXXXXXXXXXXXXXXXXXXXXXXXXXXXXXXXXXXXXXXXXXXXXXXXXXXXXXXXXXXXXXXXXXXXXXXXXXXXXXXXXXXXXXXXXXXXXXXXXXXXXXXXXXXXXXXXXXXXXXXXXXXXX
