----?---------------------------------------------------E------------E-----------o------o-------------?-----?--------------------------?----------------------------------------------------E--?-o------
--------------E------------?--------o-----E--------------------------------------------------??--------------?-----------------?-----------------------------------------?------------------------------
-----------------------------?--E--------------------------------------------?-----------------------?---------------------?---------------o--?-----------E---------------------------------------------
------------o---E------------------?---?-------o---------------------------------?-------------------------?--------?-------------------------o---?-------o---------------------------------------?-----
-------?-----------------------------------------------------------------------------------?-----------o-------------?--?------o?------?------------------------------------E--------?------------------
-----------------------------------------------------?----------?---------------------?------------E?------------------------E------------------------------------------?-------------------------------
--?----------------o-----------?------------------E----------------------------E-----?--------------------------------------------------o-----------------------?-------o--------------?----?-----------
-----------------------?---------E------------------------?--------------------------?-------o?----------------?----o-----------?-------------?------E------?----------------------------------------?-v
------?-----------o---?---------------???-----?--?----E---------?--?----o-?---?----o-----?--?------??----o-------?---?-------------o--?----------o-?--?--------??--o--------E------?---E??-----E---?----
----?E-?----??-?-o-----?--?--E-?------------?---------?------------??oo-E-----?------------?-?---o-??---o?---o?--E-?E-E---------o-?---?--------?--o----E-o---o??------------o-?-------?-----------------
----o?--o--------?------?--o----?-------------------o-E---?----o-Eo-----?----------E---E-?---o--E--o-??------E-------------------?-------?-----o--------------------o--------?---------------?-------o--
-----o-o---o?--?o--o-E------??-?----o------??--o--?-------------E---EE-o-----------?--E----??-------------------------E----?------------E------E--o?o-----?-E-E---------------?--------------E-------o--
---------o-------------?-E--------o-Eo--------E----o------T-?--E---E--?|-?----?-E---?------------?E---------oEE-?---E-?------o---o------------?-----E-?-------?-----E---------o----o-------------E----?-
---------?----E--------|o?---|--??---?T----?-----?-|--?o?||?-----??||-?T--?-o-?---?---?----|---|-?-o-E-?o-?------------T-----o-?-----?--Eo------?-|----|?--o------?------?---|-------?---|-??---?--T?---
m-|---|E|||-||?|||o||-|?|---E||--|E|?|||E||?|-|--|--?-o-|||E?||o||o||-||||--||-||-|?||?--E||-|E|-|-|||oo|--?||?-|--||-|||??E--|-|-o?|-||E||--?|-|||||-|||-|?||-||oE|-|||||o|E||--|--|?--|||||E|?E|-|-||-
XXXXXXXXXXXXXXXXXXXXXXXXXXXXXXXXXXXXXXXXXXXXXXXXXXXXXXXXXXXXXXXXXXXXXXXXXXXXXXXXXXXXXXXXXXXXXXXXXXXXXXXXXXXXXXXXXXXXXXXXXXXXXXXXXXXXXXXXXXXXXXXXXXXXXXXXXXXXXXXXXXXXXXXXXXXXXXXXXXXXXXXXXXXXXXXXXXXXXXXX
