--------------------------------------------------------------------------------------------------------------------------------------------------------------------------------------------------------
--------------------------------------------------------------------------------------------------------------------------------------------------------------------------------------------------------
--------------------------------------------------------------------------------------------------------------------------------------------------------------------------------------------------------
--------------------------------------------------------------------------------------------------------------------------------------------------------------------------------------------------------
--------------------------------------------------------------------------------------------------------------------------------------------------------------------------------------------------------
--------------------------------------------------------------------------------------------------------------------------------------------------------------------------------------------------------
--------------------------------------------------------------------------------------------------------------------------------------------------------------------------------------------------------
-------------------------------------------------------------------------------------------------------------------------------------------------------------------------------------------------------v
--------------------------------------------------------------------------------------------------------------------------------------------------------------------------------------------------------
----o---B---B---?-B----XX----?-?-----------------B---MB-----BB---M--B??---o---------ME------MBM--?-?-Mo----E----------------EM----E--?B----------?EEB--------o?M-MX--------B--M--?-E?-M-?M----EMBX------
---B----?------------?EX-E-B----X-----B?----E--?E---E-E-?-----?---?E---o?--------?-------B---Eo------B--E--?--M-----?-----------B-E--------??MB---X-X---o-E--X?E-BX-----?-B-oo--------M-E--------XM-M---
--------------BM-o?o----X?-ooo-?X------------B-----?-------EE--EoM---E-----o-?E---E---?B----oB--?----------B------E-----?--?Mo--M---------------EX-X---o--oEX--EM-X-o----EX-oE-oo-?o-oo--E-M--Eo--X-----
--------?---oB-?-EE-----XX----?oX?--------M---E--------o--B--------------E-E-o--M---EE-B?---X---o-Bo--oXB-B---B----o-M?-?-Eo--o------o-------?-X-?X-XX-----Xo-----X-M-E---X?X-B--o---M--o------X?-oXX---
------X--Eo-----XBBoE----XXX----X----?-B------?----M---M----B--EM--?------X----?-------oXBXX-BM?E--XX-X-?-oB------E-M----M-o-E-------E-B-------XXXXMXE----?-XE-o-X------E--X--M-E--MB-----o-----X-XX-E--
mME----X-B--X---oX--XX--o-XX---??XM----B--M?----X-M---X--M???--?---------X--?-B-EEE----X-MXX-oXo----XX-oX?----XBoXE-X--B-Mo-oB-B----X--ME-M---M?XXEMXX-X?X-X-?---X-X--?Eo-X------o--E-BX?-XB-B-X--XX?---
XXXXXXXXXXXXXXXXXXXXXXXXXXXXXXXXXXXXXXXXXXXXXXXXXXXXXXXXXXXXXXXXXXXXXXXXXXXXXXXXXXXXXXXXXXXXXXXXXXXXXXXXXXXXXXXXXXXXXXXXXXXXXXXXXXXXXXXXXXXXXXXXXXXXXXXXXXXXXXXXXXXXXXXXXXXXXXXXXXXXXXXXXXXXXXXXXXXXXXXX
