--------------------------------------------------------------------------------------------------------------------------------------------------------------------------------------------------------
--------------------------------------------------------------------------------------------------------------------------------------------------------------------------------------------------------
--------------------------------------------------------------------------------------------------------------------------------------------------------------------------------------------------------
--------------------------------------------------------------------------------------------------------------------------------------------------------------------------------------------------------
--------------------------------------------------------------------------------------------------------------------------------------------------------------------------------------------------------
--------------------------------------------------------------------------------------------------------------------------------------------------------------------------------------------------------
--------------------------------------------------------------------------------------------------------------------------------------------------------------------------------------------------------
-------------------------------------------------------------------------------------------------------------------------------------------------------------------------------------------------------v
--------------------------------------------------------------------------------------------------------------------------------------------------------------------------------------------------------
----o---------B---------B----E-?----------M----?Eo----M---X---o-o-------------B----M----E?--B---------------E---B----o?---?-----------B--o------E----B---B-M---E-EE-B---M-------M-?----o--o?--M-B--?-?--
-B----------------M---?--M--o-B-------B------?-?-----?-M--XoM-o------?---E---o--?-----?-B---BETo---E?-E-EE---B--?E----?--E-E----M-B----------E----E-------M-------------?----E---------X--BM----o-------
--T--BB--M-?T--o----?-B-BEo-M---o---E-o-M------BE---E---TTX------MM--------EBo-M--B---B-------|---TB----?---------E----MMM---B--E-----TB---------B---Mo---ME--------T--B-T----T-----M---XXXo---E-B---E--
-?|T-X--?---|EB-----?---T-M--MTE------oo-----ME--?T----B||-X---E--------B-XXTT--TBEXoBT-M-----|BT-|-T--B-o------BT-TT---B---T------T?-|---------T-T------?-----M----|--?T|----|----TM----X-----?T-T-----
--||--XM--?T|TTTT?-oT--T|-ETTo|-----T---o-TE--XT?-|oT---||EX-XT-B-T-TTT-X-XT||T-|--X-M|-ETTT-T|-|o|M|----T-T--E--|T||?MTTEo-|--?TTT|T-|---ET--T-|-|-TM-M--M-?--XTM--|-TB||--?-|?TEE|-ET?-XMBT--?|-|--T--
m-||-XX----||||||---|--||-X||-|-----|-----|--X-|--|-|---||-XX-|---|-|||--X-||||-|--X-X|--|||-||-|-|-|----|-|-----||||--||---|---|||||-|----|--|-|-|-|------X---X|---|-|-||----|-|--|--|-X---|---|-|--|--
XXXXXXXXXXXXXXXXXXXXXXXXXXXXXXXXXXXXXXXXXXXXXXXXXXXXXXXXXXXXXXXXXXXXXXXXXXXXXXXXXXXXXXXXXXXXXXXXXXXXXXXXXXXXXXXXXXXXXXXXXXXXXXXXXXXXXXXXXXXXXXXXXXXXXXXXXXXXXXXXXXXXXXXXXXXXXXXXXXXXXXXXXXXXXXXXXXXXXXXX
