--------------------------------------------------------------------------------------------------------------------------------------------------------------------------------------------------------
----M--------------E-----------?------M---E-E----------?-----?--------------------------E------------------?----------o-------------------------------------------M-------------------------------------
-------------------------M------?----------------?-----------------?--------------------------------------------------------E-----E------B------------------------------B--------?------E---------------
--------E---B------------------------E---------M--o-----?---------------------------------------?------------E------?---------B---------o---o-----------------------------------------o------B----------
-------o-?----------------------o--------------------------------------B-M?---------------------B----?-------------------------o----------------B--o-----------oE---B-----------------M-----------------
------------------?----------B----------?------------------o-------M----------------B---------?------------------------Eo-----?---o------o----BM---o----------M------------o----------------------------
--------------------------------------------------------M-------M-----------?----?-----------------------------------B---------?-E--------------------------?-E----?----------------?--------?----------
-----------------------------------------------?----M------------------M---M----o-Mo---?------------------------E-------?----------------------------------------------------B-------------------------v
----------E----------?-------?------------E---------------------------------------E------------E-------------------B----------E-------B-------?-------------------B------o-----------M-----------------f
-E-o-------EE-?----B---M--o?--E--M------------M----E---------o--E----o-------M-M---?----EX---B---?---oB-----??-----?-o-M-------B----?-E------B--?-----ME-------------?-----E-------XE----?-?-M---------f
------M------o---------BE-E----M---o---------B-B--------o---o?oB---?--B-------?-MBM---E?BX---M--B--?----o--E--E-E-----oo---EB-?--E--E----------------T-?---?---oE-M-o-----B---B-----Xo----o--M---------f
---oM-B---X--------?--M-----------o-----MMo?----?-------------ME-BB------EM----XX-----M-XE---?EBB--Bo----?-E--M--?--BM----------MBoB----B-X-?-B-----B|--?----B-?oMM-----o--oM---M?--E--E--M-o----------f
-----E-TX-X--E--E-----B----B-M-------oT-M-----M-oM-E?------------?----?----M--?XXM-|-BM-oXE-----T---BEM-------E--E-XX-------------E----B-XXooBB------|-----E-?--?-o-o------E-?--o--XXE-----To----------f
-?-TX-T|-X-E-M-E-TMT-o---MX-T----o-T--T?-MT--TT-o-MoTE----oM--TXM-?-B-T-|--M--XEX-T|-----X?-E-To|--E---ToT--?---MB-Xo-?TTTE---TMTT--TTT-?X-----M-T-T-|BET?-T?-ToM-T--To-TX--TT--ETT-XM-TT-T|-T---------f
mB-XX-||-X-BB----|-|-|---B-X|-----B||-|---|--||-X---|-XX-X|-X-|-XXX-oX|-|-XXX--X--||----XX--X-----|---X|-|-|-------BX-X|M|-||---|-X-||---|-XX-X--|-|-|--|--|?X|-X-|-B|-X--X-||---||---X||-||-|---------X
XXXXXXXXXXXXXXXXXXXXXXXXXXXXXXXXXXXXXXXXXXXXXXXXXXXXXXXXXXXXXXXXXXXXXXXXXXXXXXXXXXXXXXXXXXXXXXXXXXXXXXXXXXXXXXXXXXXXXXXXXXXXXXXXXXXXXXXXXXXXXXXXXXXXXXXXXXXXXXXXXXXXXXXXXXXXXXXXXXXXXXXXXXXXXXXXXXXXXXXX
