--------------------------------------------------------------------------------------------------------------------------------------------------------------------------------------------------------
--------------B----E-----------------B--M--------------------------o-------------------------M---------o-E-------------B-----------M----------------oB----------o---------------------E-----------------
-------------------E---------------?------------------E-----------------?-----------B------------E-------B----------o------------?-------------------------o--B-----------------------------------------
---------B-----E-----------o-------------------------o-------------------------------E---o-------M----------M----------------------?-------------o----------------------------------------B-------------
------?-----------------E-----E----------E--M--??-------------------------o-E-o---E-----------------------------------M-----M------E------------E--------?----M-M--------------B---E?-------------------
-------------M--------------?--o---------?----E---o---o--E-------E----E---?-----------------------o?M-o-------------?-?---?--?------------?----------------------------B-----B--------------------------
----E-----E------------------------?-----------B-----------?-----------------E------------M---------------------?----------M--------E-----B-----?------------------------------?------------------------
--------------------o-------M-----------------------------------------------------------------------------------?----------------------------M-----------?--------------?--------------BB--?-----------v
-----?---------------------B-----M----------M---------------------?----E------E--M-B--------------B------M-----------------E----o--------------------------------------B------E--E----B-----------------
----M-EE-?---?-E-----Mo--------M--?-B---------E--------o-----M--M---------B---E------E---M-?------------o--?-----oM-----?---MX-B------E--------M---B------ME--o--B-??---------o---XX-XMM--oE------------
-----------?--BBMB---?-B----EEX-M--?-?-------?M---E-------o-EB--M-----o-E-?---?B-------M------E--------?----EB-----------o--?-XM------?BM----BE--E?-M-------o------o-?-EBE-?----MMX-X------B------------
-BMMo----BEEo-X---EB-E-------Xo-o-----------MBo---M?--MoEE-B-?E--------B-B-M--o----B-----B-B-B-B---E----------E--M---|---o--M-XM------?----M--E----------------------?-E------?-B-X-X-T---B-------------
---XXo--T----E-X--B-o-MX----X?E--M?---M--B------------B?-?Eo----o-T----|---E-----o--------XXo---XXMEX-T----E-----M---|-----?--M-X---T?------??-?--------oo---EB-----?T-------M--?-----TE---M------------
--XX--M-|-EB-?----TBX?X---X-XXE-?oT--T-?T-M-o--Xo---T-XT-----TEM-T|M-B-|--E---M--T-T?o|-o--X?XE--XB-X-|E-M|---T---?TT|BB--?MT--X--T-|--?XTB??To--BTo-?TT-----?--X----|T-o--T---X-|--X-|--X-XX-----------
m-X-o|--|-|---BX--||-X--|-X-X--X|-|-X|-B|-|--|---B--|--||-X--|-X-||--|-|B--X|----|M|-||-X--|-X--|-XX-M|-|-|BXX|-B-?|||--XX-X|-|||-|-|---X|---|-XX-|-|-||?X|-MXBXB--B--|--X-|-|--X|X-X-|-|-XX-X----------
XXXXXXXXXXXXXXXXXXXXXXXXXXXXXXXXXXXXXXXXXXXXXXXXXXXXXXXXXXXXXXXXXXXXXXXXXXXXXXXXXXXXXXXXXXXXXXXXXXXXXXXXXXXXXXXXXXXXXXXXXXXXXXXXXXXXXXXXXXXXXXXXXXXXXXXXXXXXXXXXXXXXXXXXXXXXXXXXXXXXXXXXXXXXXXXXXXXXXXXX
