--------------------------------------------------------------------------------------------------------------------------------------------------------------------------------------------------------
---M---------------------------------------------------------------------------?----------------E------------------------------------M-----------------?-------M----------------------------------o-----
--------------------E-------------------------------------o---------------------------------E----B------------------------M-------------------------------------------------M-------------M-------------
------------------------E--o-M-----------?-----------------------------------------------------------------------------------B------oo------------------------------------------------------------------
--------------------------------------o-E---------------o---------M-----------------------------------------?----------------------------------------------------------------------o--------------o-----
----o------------?------?---------B?----------------------------------o-----------------------------------B-------------o--------M----------E-o--------B------B--------------?--------------------------
-o----------------------------E--------------M-----------------------M-----------------------------------------------E-------------------E---B----------------------M-------?-----o----------B----------
-?---------M------------------o--------------------B----o---M----o-------------------M-----------------------o-----------------------------------------------------------------------------------------v
-------------------------------------------------------?---B-------------------------------------------------------------------------------------------------------------?------------------------------
-E--B-----?-------o--B-o-M----E------E-?--?-?M-o-EE--oE----?-M-M----BB-------?----?-M-----M--------M-------?--oo-------?-----M------Bo--MB------------M-----?-Bo--------M-?--B-E--M--E-Bo------------M--
-B--B--------B----B---E--X--------------EE-?-o-----M-?o-M-?--?-?---E-----oMB--B------?-o-------MB-M------MM-M---M?-B------E--E----?-EoM-BB-----o------------B----?o--?--------B---o--M?-----M--M?-?-----
-E-E--?--E---?---B----M---X-------E-M?--?E-M??B-BM---------EEo---?M--E----M?-M---BM-----E-o-------o---M----B-o----M--M--o-B-----B---B----M-------------------MB------------o-------M-?---------B-o---M--
--E----o--o----?MEo-M----?-X-----E-?---B-----?-M--MB-E-Eo----B---ooEB---oo---o-----?o--Eo------E-o--o----B------B--MBE----?M---oB--E----------o--M-M-B-----M-E--------E---B----E----M---X--o--B----?o---
---?--?--?-----o-E--?-EB----Xoo------B-MX---XE-------B---E--M-----E-E---M--o-------XMMB--M?---E--E--M--M-B--MT---------M-----M-------M---M------o---------E---Mo-----o-?-M--?--B-----E---X--------?E??--
m?---oo----------??-X----M|XM-XX-E-----MXX--X---?-------MME---XM-----BM---X?---X--MX---E---X-?-?BXoB?X------M|ME-?---X------X-B--X--EXBEX---X?-oB-E--?-----oE--E--MX--X-----XM?--M-XXB?-MXM----o--EXX---
XXXXXXXXXXXXXXXXXXXXXXXXXXXXXXXXXXXXXXXXXXXXXXXXXXXXXXXXXXXXXXXXXXXXXXXXXXXXXXXXXXXXXXXXXXXXXXXXXXXXXXXXXXXXXXXXXXXXXXXXXXXXXXXXXXXXXXXXXXXXXXXXXXXXXXXXXXXXXXXXXXXXXXXXXXXXXXXXXXXXXXXXXXXXXXXXXXXXXXXX
