--------------------------------------------------------------------------------------------------------------------------------------------------------------------------------------------------------
-----------------------?------------E---?------M----------E----------E-----?----------------------o-B-------------E-------------------------o-----------?--------------B---M----------------------------
--E-----M--------------------------BB-----------------o---------------EE------------------------------------------------------------E----------------B---E---------------o-------------M-B--------------
--------------E------------------------------?--E-------------------M-------------E-?---?---E----E------BE---------------------------E----E---------------?---------o------------------B----------------
--------------------------B-?--M-----------o----------B---B----------------------B-------------E--------o-B--M---------------------------------------------?--------------------------------------------
----M-------------o-------------------------------?-------------B--------------------BB----o------E-------o-------o---------?-----------------------B----o-----------------------------B----?-----------
-------------?----?----E----------------?------M---B--------------------------E----------------B--o-?---------------?------------?--------------o-----------------M--B----------------------------------
--Eo--?--------------------ME--------M-----------o--------------------------------o----------B-B------o---B--------------------M------------------------B--------------B-------------------------------v
--?---------------------?------------------------o----M------E---------o----o-----E---------B--------------?-----------------ME----Eo------?--------B------------B?---------------o----?---------------f
---B---------Boo--M-M----E?--o-E---?--o---------------B-EMB------------Mo-------------M??--M----B-BE-M-----E--E----B-----------B---o-ME-?X-XM----E----------E-E---B------M--?-??E--M?--?-?M------------f
-------------M-B----E---------------E-------o-------B-------o--?M----Moo---?o-------?------?---?B----EBM---------M------o-BB------oBE--oX---X-B---B----M----o?--B---?---M-------E-?-----M----T---------f
--------oB--E-?-o----------E--T--------ME-----------E----?-M--X-?--o-X----------------------MBo---?--X-B-----o-o--E--------------X--B----X------?---E-?-------B---E---MB--BE-??--B------?----|---------f
--BMXM--------?----XM--BM-?---|EEBoM-----TBBBE?-----------?--XTB----MXT---BB--E--ME------TE--TX-o----X------oX----B-M--E-------XX--TM--E-XXXE-o--E--?--?E--XX?----?-E?EM--EE----o-----BE----MT---------f
----XXT-T---MT--E-X--EX--ETE--|-TM--?----T-XT---oT----TT?--oE-|T----X-|MTM--XETX--oBTT--o|---T-X----XTX-TE-o?---o?--ToT?TT-oX--XX--|T--oXXEXXo-TBT?X--T--oBoX---M-o--?X---T--?--oT-M---X-X?-o|---------f
m-----|-|----|-|-|-XXX---o|BB-|-|-----|--|-M||--X|--X-|-|---X------X--|E|--XX-|-|--X||---|-X-|-XX---X|-X|-XX---?X---|-|-||-X-X--X--|---X--XXX--|-|MX|-|-XX-----B----EX----|------||--|--XX--X|---------X
XXXXXXXXXXXXXXXXXXXXXXXXXXXXXXXXXXXXXXXXXXXXXXXXXXXXXXXXXXXXXXXXXXXXXXXXXXXXXXXXXXXXXXXXXXXXXXXXXXXXXXXXXXXXXXXXXXXXXXXXXXXXXXXXXXXXXXXXXXXXXXXXXXXXXXXXXXXXXXXXXXXXXXXXXXXXXXXXXXXXXXXXXXXXXXXXXXXXXXXX
