--------------------------------------------------------------------------------------------------------------------------------------------------------------------------------------------------------
--------------------------------------------------------------------------------------------------------------------------------------------------------------------------------------------------------
--------------------------------------------------------------------------------------------------------------------------------------------------------------------------------------------------------
--------------------------------------------------------------------------------------------------------------------------------------------------------------------------------------------------------
--------------------------------------------------------------------------------------------------------------------------------------------------------------------------------------------------------
--------------------------------------------------------------------------------------------------------------------------------------------------------------------------------------------------------
--------------------------------------------------------------------------------------------------------------------------------------------------------------------------------------------------------
-------------------------------------------------------------------------------------------------------------------------------------------------------------------------------------------------------v
--------------------------------------------------------------------------------------------------------------------------------------------------------------------------------------------------------
--?-?-X-X----E--------?----?--XX?XEX-X-----?--------------?-X-X------o--X-?-?-?-----?--E-------?--------EXXX----E----?--------E------------?----X-X----------o??-------o--XX--------XX-X-----XoX-X------
----EooX-----------?---X?-?-EE-X-XX-X?-?-----?-E-------------X--X------X------Eo---Eo-------------------X--X--?--E-------------oo---X--?---------X---------?-------E-------X??---?--oX-X---E--X-X-------
-----XXXEX--?------X---X-----XX---X-XX-?------?---?--X-?--?-XX-X------X??-??------E--o---?--EE----------X--XXE--?----------------E---X-X?---XX---XXX-?EE-?--EX?E----?o------X---------XX-?-??--X?X-E----
-?E-XX-?X-o---------X-X-X--o-XX--XXXXXE----oo--oo-?-?XX--?---XX--?XX?X-o?-E----?-X---E?----------?o-?----XX-X---------E---------o?-?XXX--?--X--E-XXX?-----E-oX-------?X-E--o-X------Xo-X-------?XE---?--
-?-XXXXX-X?-?--oo-E?-XEX--X--X----XoX?-X-----o----ooEXXX-?-X-XE-o?XXX------Xo--oXE---X--X---E----X-----?-XX-X-------XX-------?-X?XXXXX------X-?--XXXX-----E-X--?X---E-XX-oX--oX??-XX-o-XX-?---X-XX---?--
m-X-XX--X-oEo-?XXX--X?X-X-XXX------XXX-XoX--?XE-X-X-?XX-X-X-X-E--XXXX-oX?---XX-XX?X-X-XX-X-X--?o-X-X-?-X-XX--X--?-oXXEXX-E---X-XXX--XE--o-Eo-XX-X?X?X--??--X---X-?o----X-XX-XX--??X-o-X-X?E-o-?X-X-?X---
XXXXXXXXXXXXXXXXXXXXXXXXXXXXXXXXXXXXXXXXXXXXXXXXXXXXXXXXXXXXXXXXXXXXXXXXXXXXXXXXXXXXXXXXXXXXXXXXXXXXXXXXXXXXXXXXXXXXXXXXXXXXXXXXXXXXXXXXXXXXXXXXXXXXXXXXXXXXXXXXXXXXXXXXXXXXXXXXXXXXXXXXXXXXXXXXXXXXXXXX
