---------------------------------------------?----------o-------------------------------------------E-------?--------------------------------------------?--------------o-------------------------------
-------E-----------------------------------o----------?---------------------------------------------------------------o--------------o--E---------------------------------------------------------------
------------------------------------o-----------------------------?--------------------E---o-----?------------------??----------------------------------E-----------------------------------------?-----
--------?-----------------------------------------------------------------------------------------?---------E------------------------------------?---------?--------------------------------?-----------
------?--------------------------------------------------------E-----------------------------------?---------------?------------oE-------o---o-----------------??---------------------------------------
----------------------o--------------E---------?---E------------------------------------------------?-E----------------------------E----------------o-------------------------------E----E--------------
--------------------------?--------------------------------------------------------------?------------------------?-----?------------------------o-----------------?------------------------------------
----------------------------------------------------------------------------------------------------------------?------------------o-------------------------------------------------------------------v
------------o--?------------------------E-?------------------------------?E----------------------------------?----------------------?------------------------------------------------------------------f
------------------------E----------------------------?--------------?-------------------------?-----------------------------E--------------?-----------------o-----------------------------------------f
--------o---?-------------E--------------------?---------------------E--------?------------------------------------------------------------------------------------------------------------------------f
-----?----------------------?-------?-----------------------------------------------------------------------------?--------------o---------------?-----------------------------------------------E-----f
---------------?----?----?-----------------------------------------------------------------------------------------------------------------------------------------------------E-----------------------f
--o---------------------------------------------?-----------------?--------------------------------?---------------------------------------------------------?---------------------------------o-o-----f
m--------X-------X-------------?-----E-X-------------?---------X---------?---------------X-----------------X----------------------?-X-------------------------XX--------?------------------------------X
XXXXXXXXXXXXXXXXXXXXXXXXXXXXXXXXXXXXXXXXXXXXXXXXXXXXXXXXXXXXXXXXXXXXXXXXXXXXXXXXXXXXXXXXXXXXXXXXXXXXXXXXXXXXXXXXXXXXXXXXXXXXXXXXXXXXXXXXXXXXXXXXXXXXXXXXXXXXXXXXXXXXXXXXXXXXXXXXXXXXXXXXXXXXXXXXXXXXXXXX
