--------------------------------------------------------------------------------------------------------------------------------------------------------------------------------------------------------
------------------------------------------------------------------------------------------------------------------------------?-------------------------------------------------------------------------
-----------------------------------------------------o-----------------------------------------------------------------------------------o---------?----------E------------------o-------?--------------
---------------?--------------------------------------------E---------------------------------?--------------------------------?---------------------------?--------------------------------------------
-------------o---E---------------o----------------------------------------------------------------------------------------------------------o-?------?--------E-?----E---?-------o----------------------
----?---?------------------------?----------------------------------------------------?----------------------------------------?-----------E----------------?-?-E------------?--------------------------
--------------------------------------------------------------------------------?------------------------------------------------------o------?---o---------------------------------o---------------?---
----------o------o------------------------------?--------------------------------------------------E--------??-----------------------------------------------o-----------------------------------------v
--------------------------------?----------------E--------------------------------------?----o----------------------------------------------E---E--------------------------------------o----------------
---?--?-----?-?-----?-o-----E-?E-?-E--E?---???-------oo------??-----E-?--o---------E---?-??-EE------?----o--E-----?-------E-?-------?---E-----------------?----------E--??-----------?------------o?----
-?------?-?-E-?---?-o-----o---?-------oE-?---------------o?--------o----?-o------E-------o--E-?----??-o---?-----o-??-----?--E--------------E-?--?-----o--------?-------o-?----------E-E---??------------
------------o-?-?---?---------?-?-------E--?-----?-?----E-----------?-?----E---?------oo----o------------E-?----?------?---E-o------o?------?-?--------E?------?------?----o---?----?--------??---------
----------o----?--?-----?-?-?----------?o--E------o---E-E-------------E-?-E-E?--E-------E--E----------ET?--?--o--E-----E-o---?-----o----------?--------------------------?--?-----------?--------E--o---
-?--E------X---------TET----T-----?-T--o--?--TE----?------o?o----------?--?T-|?--?ooE----X-?E---TEoT---|T-----Eoo-T--E--o---?------o-T?----?E------?----------------------E-----?----T??--o--o----E-X-X-
m----E-|----X-o------|-?--oE|--?--XE|---X--E-||-Eo--EE-o-|--?X---?-----XE--E-||?-E--EEX-X-----oX|--|---||E---|-o-X|---EE----|--------|-?o---?------?---o-??-------o--E---------?--E-----oo---E---X-X|-X-
XXXXXXXXXXXXXXXX-XXX-XXXXXXoX-XXXXXX-XXXXXX-XXXXXX-XoXXXXXX-X--XX-XXXX-XXXX-XXXXX?XXX-XX-XoXXXXXXXXXXXXXXXX-XXX-XX-XXXXXXXXX-XXXXX-XXXXXXXXX-XXXXXX-XXXXXX-XoXXX?XXXXXXXXXXXXXXXXXXXXXX-XXX-XXXX-XXXXoXX
