--------------------------------------------------------------------------------------------------------------------------------------------------------------------------------------------------------
---------------------M?-------o---------------------------------------------------??---------------B------------------------E------M-----o------M--------------?-----------------------M----------------
-----B---------E--------------------------------M-------?-------------B---------------E-------o---------------o---o-------------------E-------o---------------------------------------------------------
------?-----------------o------------o-----------------o----------------------------------?--?M--------------M----------------------------------------?--B----------------------------------------------
--------------------------------?---------E-----o----M-o-o------------o-------?--------------------MM--E---------------M-----------------------------M--------------------------MB-M----B---------------
--B----------------------E----o---------M---o-----------------?o---------?---o-------------B----------E-B--------------------------?----B---------------------?--o------------------------o-------------
-----------------------M-----M---------------------E----M-----------M-M?---M------M--------------B----------------------B-o----B---M--------------M------o-------E--BM---??--------------BE-------------
--?--------------------------------M--B-----?-----------------------M---M------------------------------------------------------------------o-o------?---?------------------------B----E-o--------------v
-B------------------------------M------B-----------------------------------------------?----------M------------M----Bo--E-E-----------------o-----------M------------------------M--?------------------f
------B----oo----B-M---------------oo----E-o--MEBM--------Xo--E---oEo---E-?----?E--o--EBM----B-------?--E-M-M-B--M-----M---?-------?--------?-ME------BM-Eo---?o------?-----?M----E-o-M---EM-o---------f
------M?------------E----------o--M------BM--E-o-M-------BX--M--?-------B-E?-o-?--B------B-E-XM----B-----o--E----------------E-EEB-?-o?-------E-----E-B--E?-----o------M--E-BEE-B--o--M--BE?-----------f
---X-E---o--E--M-----M?--o------B---M-----B-oBMM------EE--X---BE--?B------E-?-----E------oo--XB-?o----?---------?--o----M-B----o?---o---?M-o-B---B--MBE--o--oT-MMB------E?------M------o-B--o----------f
----X-------B-------------M-------M-------o-?-??--------E-E-B---M-EXB---B-?-B--o-B--?-----??-X-M-T---oo---MM------?E--------?--T----oT--BTE----?--E--?-------|--oX-M-----------B-------T----?----------f
-|-Xo---T-T---?-M-T----B-B-TETT-E-ToT-EBMT-MX-X-B--oE-TX-TE---X--XXo----?--B-T--T--E--MM--o-EXM-M|T----?TTo-TBXT------T--o--M--|MXXT-TT--|?T-T-|-----?---o---|--?-X-TT---B?TT---T---TT-|----?----------f
m|--X---|-|----|-X|-B---XX-|-|------XB--X|---X|--X||-X|-X|X-|-X-B-X-X-X--B|-X|--|--XX?XXXXXX-XXX-||-----||--|-X|?|--XX|-X--XB--|-XX|-||--X-|-|-|-----X--BBM|-|---X--||--X|-||-X-----||-|-X---X---------X
XXXXXXXXXXXXXXXXXXXXXXXXXXXXXXXXXXXXXXXXXXXXXXXXXXXXXXXXXXXXXXXXXXXXXXXXXXXXXXXXXXXXXXXXXXXXXXXXXXXXXXXXXXXXXXXXXXXXXXXXXXXXXXXXXXXXXXXXXXXXXXXXXXXXXXXXXXXXXXXXXXXXXXXXXXXXXXXXXXXXXXXXXXXXXXXXXXXXXXXX
