--------------------------------------------------------------------------------------------------------------------------------------------------------------------------------------------------------
--------------------------------------------------------------------------------------------------------------------------------------------------------------------------------------------------------
--------------------------------------------------------------------------------------------------------------------------------------------------------------------------------------------------------
--------------------------------------------------------------------------------------------------------------------------------------------------------------------------------------------------------
--------------------------------------------------------------------------------------------------------------------------------------------------------------------------------------------------------
--------------------------------------------------------------------------------------------------------------------------------------------------------------------------------------------------------
--------------------------------------------------------------------------------------------------------------------------------------------------------------------------------------------------------
-------------------------------------------------------------------------------------------------------------------------------------------------------------------------------------------------------v
--------------------------------------------------------------------------------------------------------------------------------------------------------------------------------------------------------
--o---------X?X?XXXX?E--?---?------E--??-o?--?-----EEX---------X?XXXXX-------E-X-Xo--o--?X----EE?XX-------??---------?E-?XEoXX?--X-EX-X?------?E----?---X----??-----?-E---------o-Xo??------o-?--E------
--E----o-o?--XoX-X?X?-EX----------?---X-------?----?-X----oE?-o-XXX-X--E------XX?X-----XX--------X-?------o-X?E-----XX??-XXXX-----XX-X--------E--------EXE----o-------?-?o?------XX----??--?-?-o-?------
-?----?--E--??X---XXEXXo---E--E--Eo--?Xo--?o----o---X--o--------X--X----?---?--XXX??----X-------oX--E------XE--E-?E-XXX-??XXX--E--XXXE?-o-?------XX-o----XoE-------?E---o--XX--?--XX------?----?-?---E--
------------EXX---X---X----?----o?-X-X---------X---ooX-X-o------X?X----?-o----X-XX---X-X----E----X--?------X?XXE--?-XX|E-X--XX-E---X--------------X?oX?--X----E-Eoo---?-TEXXXX----X-oo-X--E-E?----E-?---
---To--------X----X-XX-E?------XX-XXX------E--XX-o-XX??EX?T?o---oX??--?------|-XX----XXXX?-EoTE?X-----X-X--XX-?XXX-E-X|-X----X-T----X--o-------?--X-XE--?X--?-?--?T-EXX-|--X-XEX---X--X--E-XXo---o-o-?--
mE?|-???---oX--o-oX?|XXE?---E-XX-XXX|??o|?o---X|??X-|X|-X-|-E-E--?X-------o--|XX---XXXEXX-E-X|-X----E--X?-?-X-X-X?-X-X|o?XX-X-?|--??-X?X---?---X|E-X??---|X?------|--XX-|XX--|XX-?-X|oXX--XX-?--?|-|?---
XXXXXXXXXXXXXXXXXXXXXXXXXXXXXXXXXXXXXXXXXXXXXXXXXXXXXXXXXXXXXXXXXXXXXXXXXXXXXXXXXXXXXXXXXXXXXXXXXXXXXXXXXXXXXXXXXXXXXXXXXXXXXXXXXXXXXXXXXXXXXXXXXXXXXXXXXXXXXXXXXXXXXXXXXXXXXXXXXXXXXXXXXXXXXXXXXXXXXXXX
