-B-----BM-----M-B---------------BM-M----B-------M----?----o?---o-E---Mo-----B-----E-oM--o----o-------ME----?--o-o?-----------o---B---------o-------B-----M?-B--------------o--B----M-------oE----B--?---
--o------ME?-B----------------------M--------?------?--E-o-?--oM--B--o---------?----?------------B-----------------------o-----o-E---B-----------E-----E------o?-----B--------------E--o----------o-----
-------o-MM-------------B---E?---------------o--B---o------M------------o--B-----M------------E-------?---B---------B-----B----------o------B--------o------------B----M-E------M-----M-o-----B---------
----------?-------B---------B---B--M?M-----o--------B-o?B---o-----------------E----o---E-----o--E--?------M--BM---------?----Mo-----?B-?EM-B---M---------B-----oE----B--------------E------B-----E-E--E-
----------MEM---E-oB-M-E---------B--E?o-o-B-------B------------?----?-------E-?-M-------M----E----?-o-----M-----------B----?-??o--o------?-Mo-Mo-------oB-E-B------E-M--o--------------BE--M------------
-----?---Eo-E--------B---?-?--M-----------o-o-------M--------B------B---oo----EM---------B?----B?------E?-B-----E------------M-----M----o-?B-oB--E--o----?-----B-------------?--?----EE--?---o-------B--
-----B-o-B------E-M-------M---E-----E--------?---M---?-M-?----E---o---?--------------?----o--------------o--M--------?-B--M------------BB--M?M----EM-B----E--E-o---M-----------------o---------E--------
----------------------------oo-----oE-----Mo-?-?---o---o------o--------M-----E--o---------------E-------?-o-MM--E----?ME-o-?------EM--M-----B------?--?-E--EM---M-------oo-------------E----Mo-M--B-B-Ev
-----M----------M---------------------M-----o---o--B--M-------E?-----E-------BB-E--------------?E---------E---E-B--------M---B----o-o----------------?----M-----E-M-----o---------M------B-------------f
-M-------------BM--M-----oB-----E----E?M?-o----oB-------o---B-------MM--------BB--M-o?-----M-------------------?----oB------------M-E-oB--------o-B--------oB---??----E----E--------B-B------B-MB-E---Bf
-oE-M-------o--M-------E----------B---??---E?----E--o-----E--M-E--------B--M---------------?------o----E----------?B--------------------E--------B---o--------M-?---B------E-B-----------------E-------f
---------B----?M-o-----------o---B----M---?--E?---B---E--?-B-------oo-------------?-------EM---------o---?M----B------------EB----B--B--------E----BE---??---o----B------?--------B---E----------B-----f
--?-BM------M--------?------ME--E-?--M----M??--------EE----------------EE-----M----?--ME--o-------o--------------?------E?--E---E------B-----------E------E----o---o------E---?-E-------?-------M----B-f
---M---------oo-o---M---M?E-----------------BE-?----------o---o-B----------BM--------------M----------M-----o-------------------------M-----B------E-------M------M------o--E---------Bo----------B----f
mEo------|-------o-----X-----M-|-BB-o------------M-------o-----------MB---o------X----E-X-E---o---E-----X-E------o-----?--EM---?B-o----M--------E-|-B------o--?M-?-M-?E------------B----X-|---|--?-----X
XXXXXXXXXXXXXXXXXXXXXXXXXXXXXXXXXXXXXXXXXXXXXXXXXXXXXXXXXXXXXXXXXXXXXXXXXXXXXXXXXXXXXXXXXXXXXXXXXXXXXXXXXXXXXXXXXXXXXXXXXXXXXXXXXXXXXXXXXXXXXXXXXXXXXXXXXXXXXXXXXXXXXXXXXXXXXXXXXXXXXXXXXXXXXXXXXXXXXXXX
