--------------------------------------------------------------------------------------------------------------------------------------------------------------------------------------------------------
---------------------------------------------------------------------------------B-------------------------M--------M---------E------------?------------------------------------------------------------
----------------E-------------------------------------------------------------------------o-----------------------------------------------E-------M-----------------?----o------------------------------
-----------B---E-------------------B----------------------------------------?-------------------E-----------------------------------B------M--------o--------------------o------------------------------
------------------------M-----------------------------------------------B----------------------E---------------o----------o----------------M-------o---------------------------------------?------------
-----------o------E----------------M--------------------------B------------------------------B-B-------------------------B---oE-------B-------------------o--------------E---M-----o-------------o---?--
---B------------------------------------------B---------------------E--------------B------------------?-----------------------------------------------------?------------------------------B-------M----
---------------------------------B-------X--?--------------------?-----------------------------------------E-------------------------------------------------------------------------------------------v
---o----------------------------B-X-------X--------------------------------------------X----o-M----------------------------------------M---------E--M--------E-------BX---------------------------------
--E-XXEX--o-------------o-----?-??X-E---EXXo-?-?X-XXE-?X-X---M-?-M--Xo-----?---?-Xo-XoXX?X--o-o---??-------?-----o-----E-o?-?---------o??E--?o--E-Xo------------?-?EoX----------XB-M----EX----oXX--XXXX-
-EE---X?---M-----?---?---o-oo---?o-X-----XX-oo--oXXX-?E-?---oXXX-----X-XE----E-M-oX-X?X-X?--?-?-?-???--B------o-E---o-?--XEEX-----------B-?-?-----X----?--?----?--X-X-E-?------X---o-----X-----X-BX-XEX-
-?--XX------?o-?-?--?--o---?E---ooX-XX-XoXX-?--o-X-X?--XX-M??EXXo?---XX-X-XX-o-----X--?XX??o-o------?-E------?-?---?---XX---XoM?--?o------------?E----E-?------o-??X--E------XXE-E---?-XX-?-o---XX-?XX?-
---XX----?-o----?-----B--o?--X--X--XXX-XX--X--E-o-X----E-?--XXX---XX-X----X?---o----XXX-EXM---?--EEET--??-----------o-Xo----X-X?E----------?---MM---E-E-------X?----X-E----?--Xo--E-o-T-XE---o??-X--XXX-
--?-----T--?-E-------?---X-E-X-T-XX-XTX?-XX?-?X---?XTo-X--?--Xo----X-X----XoXX-------X-M?X-X-???----|-oE?-o?------?--XXTBX-?-XXX???E-------T---M-??X-?---ET--X-T-X-XX--?--o-XX-o-E?-T-|T-X-?-?-?--XX-EX-
m--?M---|---XM---|?XX|X-X-?-MB-|-X-XX-X--oXM-X?-o?X-|XX??XX?--X?B--X--o-oMEoBXE-XX------X-?XXXX---X-|X--???-?---o---oX-||-X-X?oX|X-----?---|?E------X---o-|-EX-|X-E--?-?X?-B-XoX--o---||--X--|X----X-XX-
XXXXXXXXXXXXXXXXXXXXXXXXXXXXXXXXXXXXXXXXXXXXXXXXXXXXXXXXXXXXXXXXXXXXXXXXXXXXXXXXXXXXXXXXXXXXXXXXXXXXXXXXXXXXXXXXXXXXXXXXXXXXXXXXXXXXXXXXXXXXXXXXXXXXXXXXXXXXXXXXXXXXXXXXXXXXXXXXXXXXXXXXXXXXXXXXXXXXXXXX
