--------------------------------------------------------------------------------------------------------------------------------------------------------------------------------------------------------
--------------------------------------------------------------------------------------------------------------------------------------------------------------------------------------------------------
--------------------------------------------------------------------------------------------------------------------------------------------------------------------------------------------------------
--------------------------------------------------------------------------------------------------------------------------------------------------------------------------------------------------------
--------------------------------------------------------------------------------------------------------------------------------------------------------------------------------------------------------
--------------------------------------------------------------------------------------------------------------------------------------------------------------------------------------------------------
--------------------------------------------------------------------------------------------------------------------------------------------------------------------------------------------------------
-------------------------------------------------------------------------------------------------------------------------------------------------------------------------------------------------------v
--------------------------------------------------------------------------------------------------------------------------------------------------------------------------------------------------------
--MX??-?--o-?-----?----E-----------B-------o---E---oM-o-X-E----EB----?---B---B--------?-----?o----E--M------o?---M----M--------E--X-X-B------------B------oB?-----M--B?----MMB-?--B---o------B----------
-?-Xo----E--o-E-------E?----E---o--?M--E----E---------EX?XXM--------o--M-?o?B?-B---B-----B---E---------?o-M----------B----o------oXXX-E-----E--E-o--?-BB--BB?B--------X-?------?-o-----?----------------
---XoB-X-----EE?---?---?E---M-------------?-o--BM-o-o?oEX-XB------------oE--M----M--B--T------------Mo----M---------o-M-M?o------?BXo-?--E-------------M---E-----------XBXB-E--?EE-B-------E------------
-oM?X--XE-To-E-----o?-EB----X?------------T------ME-M-EE-X---?E-?T-----------?B------T-|-----E-B---?---------E-TB--oM------ETE-?-XXooM?E----?------oB--X-----o-M-?------X--To---M--Eo--?----B-----------
--MX---X--|-X-oTM?----T-E-M-X---T----o-T--|M-MT--TBTE----?X---XMX|--T-----TX-E??-?-T-|-|--T--?-T--M--M-o-T----X|M?-TB---T---|T---X--T--T-TE--ToB--BX-XXTEM-TToE?X-X-ETMXM--|TEME----?T-BBET-T-----------
m--XXXX--X|BX-X|-B----|-X---X-X-|-B----|--|--B|--|-|-----X-----X-|--|--X--|-X----X-|-|-|-X|---X|---------|-B-X-|--B|----|---||B-X---|-X|-|-X-|---XX-XX-|---||--X--BX-|-XX-X||--X-B-B-|---X|-|-----------
XXXXXXXXXXXXXXXXXXXXXXXXXXXXXXXXXXXXXXXXXXXXXXXXXXXXXXXXXXXXXXXXXXXXXXXXXXXXXXXXXXXXXXXXXXXXXXXXXXXXXXXXXXXXXXXXXXXXXXXXXXXXXXXXXXXXXXXXXXXXXXXXXXXXXXXXXXXXXXXXXXXXXXXXXXXXXXXXXXXXXXXXXXXXXXXXXXXXXXXX
