---------------------------------------o----------------------------------------------------------------------------------------------------------------------------------------------------------------
-----------------------o----------------------------------------------E-----------------o---------------------o------?--------------------E-------------------------------------------------------------
---------E---------------oo----------?--------------------------------------?------------------------------------------o------?-------------------------------------------------------------------------
--------------------------------?-----------E----------------------------------------------------------------------------------------------------------------------------------------o------------------
----------------------------------------------?--------------o--------------------?------E--------------------------------------o------------------?----------------------------------------------------
---------------------------------------------------------------------------??--------------------E--?---------------------------------?-----------------------------?--------------o---------E----------
-------------------------------------??-----?-------------------------------------------------------------------E--------------------------------o-----------------------------------E------------------
-------------------------------?---------------------------E--------?------------?----------------------?-------------o----------------?----------?----------------E---------------------------?-------v
------------------------?---------------------------------o-----------------o---?----?-------------------?------------------?--------------------------------------------------------------------------f
----------------------------------------------------------?--------------------------------------------?-----------?-----------------------?-----------------------?-----------E---------------------E-f
-----------------------------------?----------------------------------------?--------------------------------------------------------o-E----------------------------------o---------------?------------f
----?-------------------------------------------------------E-------------o--------------------??-----------------E-------?------------------?---------------------E--------------------?--------------f
----------------------------------------------------------o--------------------------------------------------------------------o-----------------------------------------------------------------------f
----o-------------------------?---------------------------------------------------------------------------?----------------------------------------------------------?---------------------------------f
m---------------------------o------------------------------------X-------?-X--------?------E-----------------------------------------X---------X----X----------------X------------------X--------------X
XXXXXXXXXXXXXXXXXXXXXXXXXXXXXXXXXXXXXXXXXXXXXXXXXXXXXXXXXXXXXXXXXXXXXXXXXXXXXXXXXXXXXXXXXXXXXXXXXXXXXXXXXXXXXXXXXXXXXXXXXXXXXXXXXXXXXXXXXXXXXXXXXXXXXXXXXXXXXXXXXXXXXXXXXXXXXXXXXXXXXXXXXXXXXXXXXXXXXXXX
