--------------------------------------------------------------------------------------------------------------------------------------------------------------------------------------------------------
--------------------------------------------------------------------------------------------------------------------------------------------------------------------------------------------------------
--------------------------------------------------------------------------------------------------------------------------------------------------------------------------------------------------------
--------------------------------------------------------------------------------------------------------------------------------------------------------------------------------------------------------
--------------------------------------------------------------------------------------------------------------------------------------------------------------------------------------------------------
--------------------------------------------------------------------------------------------------------------------------------------------------------------------------------------------------------
--------------------------------------------------------------------------------------------------------------------------------------------------------------------------------------------------------
-------------------------------------------------------------------------------------------------------------------------------------------------------------------------------------------------------v
--------------------------------------------------------------------------------------------------------------------------------------------------------------------------------------------------------
-------?ME-ooB-----?--o-E-------BBM-----XXE-B------M-E-B--B-o-----?---?-EM----E--MX-?-----oE-----------------M-----o--ooB-?---E------oM-M----E------B-----o--?--BMB---?----E?--?--M----o-BM-?-E-B--BM---
-------Eo-----E-o?--M--E---------------X-X-----M--?-------o-------------o----E---oX--?-E----------?---E---BM--?E---B?------------------M-X--M-BM-M-?----MB---o---------E-----------??-----M-----M----B--
-M--X-X--BX---E---B--?M-E--M-E--?EEMB-E-Xo-------------E-------M--?-------M--o----XX-----M--E-o-----oM--E--o--?--MEo--BB----------BB--o--X---oo--?---------o---X-o-E-X------o--BM----------B----ooEE----
--M-XXM--X-?-B--BX--B---E-?-o?M------B-?X-----BE-MM--?o-o-M-?---ME---E--o----o---oX--M---?--M--E-----o-------?--------o--------ooE--o?X-X---BM-M-----EE-B-------X-?---XX---X-EM--MMB--------------------
--X?BX?---XX-o?M?XXXM------X-----------XEM-?--XX--------o-----oB--o-E----XoX?---BX-E-------E-?---B--ME-B--?--EB-o-----X-o-----MM-----X-BX--E?BB--?o--?B?-----E-XX-?Mo--X--?-XEX----?----o-M----------?--
m-X--MXXX?X?M-X--XX-----EXXX---?oX----X-oB?---X?X??-----XXB------?-EM----XX--X-XX------B--E-------MMM?-B-o--MM-X-----X-oMX--XX-------XE?X--Mo-----Xo-?--?-X-X--X---BME-BXX-XoXXMB--XMo----?-BX?-X-o-----
XXXXXXXXXXXXXXXXXXXXXXXXXXXXXXXXXXXXXXXXXXXXXXXXXXXXXXXXXXXXXXXXXXXXXXXXXXXXXXXXXXXXXXXXXXXXXXXXXXXXXXXXXXXXXXXXXXXXXXXXXXXXXXXXXXXXXXXXXXXXXXXXXXXXXXXXXXXXXXXXXXXXXXXXXXXXXXXXXXXXXXXXXXXXXXXXXXXXXXXX
