--------------------------------------------------------------------------------?--?-----?--------------------------------------------------------------------------------?------?--------------?-------
-----------------------------------------------?------?---?-------------------------?-----------------------------------------------------o---------?---------------------------------------------------
----------------------------?--o---------------------------------------------?----------------------------------------?-----o-------------------o-------?-----------------------------------------------
-------------------------------------------------------------------------------------------------------------------------------------------------------------?--------------------------------o---------
-------------------------------------o-----------------------?------------------o------------o---?---------------------------------------------------------?--------------------------------------------
----------------------------?-------?-----------------------------------------------------------------------------?----?---------?------------------------------------------o---------------------o-----
-----------------------------------------------------o-----------------------?--------------------------------------------------------?-----------------o----------------o-----------?----?-------------
-?---------------------------?-?------?---------------------------------E---E------o---------------------------------------E----o--------------------------------------------------------?-------------v
---------------------------------------------------------------------------------------------------------E-----------------------E-------o----------------------------------------?--------------------f
-------?------------------------------------------?-------------------E--------------------------------------------------?--------?-----------------------------------------------------------o--------f
----------?-----E-----------?------------------?------------------------------------------?---------------------------------------o--------------------------------------------------------?-----------f
--------------------------?--------------------------------------------?----o--o-----------E------E------------------------o-----o---------------------------------o--E-----------------------o-------of
-------------?----------------------------------------------o-------------------------------------------------?--o-------------------------------------------?-------------------------?---------------f
----------------------------?--------------------------------------------------------------------E------?--------------------?-o-----------------------------------------------------------------------f
m----------------------|---|-----E-|--------------|o--|---|--?--|-------?-----------|?-----|----|---------|----------------|------------------|------------|-------------------------|--E-------o------X
XXXXXXXXXXXXXXXXXXXXXXXXXXXXXXXXXXXXXXXXXXXXXXXXXXXXXXXXXXXXXXXXXXXXXXXXXXXXXXXXXXXXXXXXXXXXXXXXXXXXXXXXXXXXXXXXXXXXXXXXXXXXXXXXXXXXXXXXXXXXXXXXXXXXXXXXXXXXXXXXXXXXXXXXXXXXXXXXXXXXXXXXXXXXXXXXXXXXXXXX
