---?-?---E-X--oEXEM-M---M-------X----E---?--o--??-------XEM----B---X------XE---------X-------B?-----?M--o-----E---B-o-----M-?---BE---X--------B------?-X-------?-------Mo-oo-?----E-?-X------------?----
----X--EX------EE------BB---MX-?---------E-----X----Bo-o---?------B-B---M---------M-X-----X-M----B-XBM-o-M------BE------MoX-EB----o-ME---M----------E--------B-----B--o-----o------?----X----M-?B?------
------ooB-X-X--M----E-o-X------o-M--------XE-----?---Bo-o-------------BE--X---?--B----X------X-------X-------o--------------------o---M---?----X--oo-------oX-----M-----o----BM--------BE---X-------M-B-
--E---B?-----BEB?---M-------E--o-X---Mo-----X-B--BB----o-oo------------M----?-----M-o------E-Eo-XoMMo--MM-EEXX-X----oo--M?---M-Mo-?M---?o------EB---B-X----B-E-----XEM-o----oB--X-----M---o--------E--?-
--?-XM---B--?X--o--------M---------o----M--o-----X--------Mo--M---B--o--------E-MBB-B-----E--MBB-------------?-o--B----??---E----M----M----M---X------------oo-----?---?------------E-X--?X-?--------X--
---X--o-----?----?----------M---M-BB--M-----X-M?M--------B-BB------o----?-----B-o----X-----B-Eo----M--?EX--BB?---B--?XE---------E-?----------E--o--o-o-----X--?-----------------o---Xo----EM-E--------?-
-M--X--B-o---?--------------?X-E?----??----?-X------?--------M-M--EM-M---X--X--E----X--------?----?-o------------MXX----XXo---E---B--E------------X---M--X--------------?--M----MM--E-----Mo-E----o---?-
-M-----X---o-o?-M-----M----?-------EXX------M---o-----?--o---X---o-X---?E---?--M?-----X--------Mo---E-----o-o----B-------B-M-------E--o---------BEX--?----B-?-----MB---o-----??E-B-----EB---B---E----E-v
-E-E---E------oE---EB---E---Xo--M-----B-X-E------XE----------o--MM-BB----M----o-----------B----BoX---M------B-oBX-?X----E------o--B---Xo---------E-------------X---------ME----o--oo------oE--E---X--M-f
-o-?EM------X--------oB----E?------------o----B?-------M---B--EE--XX-?--o--o-----?E--o-----------?B-M-X-------------------X------B---o---?X--------?-----E?oo-X----M--M-X-----o------X--E----o--E--?--Ef
------------?-----o-?-------o-X?-E--M--oBo-?-B-EB------------B-----ME--B--o-----?-----X--EX----oM--EE--?-----BM?--B-XX--o------------o-------MB--?--?-------------E-M----B--M---?-X------------?-X--EE-f
------o---X--?--o--------B----E-------?-X----B--o-B------EM---MX-X--EX-----------------------------------?--o-------X-E-------B-EE---B---o-B-----EX-----Eo--E----XM--M-o----Xoo---o--X?--o-----o?-B-X--f
-X--?--E-oB-MM-E-Bo---?B----E-M-o---------?---------------B-X------o-o--MX-X------o-------o-Bo-EE----EE-?-E?-------E--?--?-Xo--M-E------B----B--X-o-ooM-XB--E---M-EB-o-----------B-----BM?-M-----o----Bf
----------B-X----E---XE?-----------------XM-----M------?MB------o-X-------X-X--?o-?--------?----------o-?---E--M-E---o-------------XX-----?---oX--------B----------o----M--o--X--?M--o?M--------E-X?---f
m--B?o-----?--M---B|--M--------?--X----oB------|X---------?--XoE-o-M----E--|-Bo----B-E---|--E------BB--EoE-M---?B-o-X--B--X-E---o---------------------|E-----o---?-M----|----BE------X-----------B--X-?X
XoXXXXXEXXMXXoXXMXXXXXXXEXXXXEXXXMXEoX-EXXXXXXEXXXXoXXXXXXEXXXXXXXXX?XXXXXB?XXXXXEXXXXXEEXX-XXMoXXXXXXXXBXXXXX?XXXXXXXMXXXXXXXXXoXXXXXXXXXXXXXXXXXX?XXXXXXXXoXXXXEXBXXXXXBXXXXXXXoXXXXXoXXXXXXXXXX-MX-EX
