--------------------------------------------------------------------------------------------------------------------------------------------------------------------------------------------------------
--------------------------------------------------------------------------------------------------------------------------------------------------------------------------------------------------------
--------------------------------------------------------------------------------------------------------------------------------------------------------------------------------------------------------
--------------------------------------------------------------------------------------------------------------------------------------------------------------------------------------------------------
--------------------------------------------------------------------------------------------------------------------------------------------------------------------------------------------------------
--------------------------------------------------------------------------------------------------------------------------------------------------------------------------------------------------------
--------------------------------------------------------------------------------------------------------------------------------------------------------------------------------------------------------
-------------------------------------------------------------------------------------------------------------------------------------------------------------------------------------------------------v
--------------------------------------------------------------------------------------------------------------------------------------------------------------------------------------------------------
-o--?-B-?--X-?--BMBo------??---?o------oEX--------?---------B------------?------?---E-MM---EB-?----XX-----------M-oB-----X-M---?--?XX--E-BE--------?-M-E--?-----?oE-BBoB------?X-E--------E-----B--MM?--
------?----EXB--B--E-E------E----BE--?-MXo---o------B--M---E-?----M-----------?-------E--?E-?-EM----Xo-ME----M----------oX-E-------XX----?-oo--M-oo---B-E--------XE-X--B--B--BX-oB-?-----B---MEM-B---M--
-B-B-----M--oX--o-----B-?-------??---M-X--------Xo-?------?--E---EM?--X-o-----E-EE-E---------?MM?--MXXo--------o--B---B-X-o-?----?-X-XB-o-XEM---o-----------------XMXE-o?-o?XX-------------------X------
-------?----X?B-o--E-?-o---------B---EX-o--?----EX-BM-----Xo---XXX---B-X-M--o--X----?E-----B----B----XB---M---B--B----XXM?--o---E-E-X--X-X--o-?-----M--o-------X--XX?---M--?-X--M-E--------o--B--BX-EM--
--M------o-o-XE-M----?MX-MX------?X--oXo-M?--o-oX---M--E--BX-E-X-X------X-E---?X-B-X---M--?X----BB-?-EXE----E-E-?----XX-?---M--?E--XBM--XX--X---------X------BBX-E-XX-------EX-X--------E-o----o-XX-M---
mE-----XEB-X--Xo-XM--XXM--X----XMBXo-oX?E-Mo-X-X---B---X--?X--X---X-X-M--X--o-X-X-X-X------X-o--?X-ooXEB-X--oXM?B--XBX-EMM--o--o--XXXXM-XB-XoE----B-XX-X?--?---XXB-XXE-E-EX-X--XXXMo-------X---EXXX-B---
XXXXXXXXXXXXXXXXXXXXXXXXXXXXXXXXXXXXXXXXXXXXXXXXXXXXXXXXXXXXXXXXXXXXXXXXXXXXXXXXXXXXXXXXXXXXXXXXXXXXXXXXXXXXXXXXXXXXXXXXXXXXXXXXXXXXXXXXXXXXXXXXXXXXXXXXXXXXXXXXXXXXXXXXXXXXXXXXXXXXXXXXXXXXXXXXXXXXXXXX
