-----------MB--E--M-----B--oM------E---o-?-----o-?M---Eo-----------?---B-------------M-------o---B--------E------M--------o-----------?------------M-----E---------M-oM------------o---BE-o---B------M--
---------E-?--?--B------E--o---?B--------------M--M---MoE----oM?---B----------o--E-E--o-----M--------E--E-EEM----?----o-E-----E---------------------o--E-B--------E-------E-MM-B--------B---?-?---------
-o---M---------M----M---------?--------o-B-------?-B-EE-E---o--?---E------o-----E-----M-MBo-------------E-oEE---B-------------Eo---------M---------?-E-------------?--o----o----M-------M-M--?E----?----
-EB----o---M--E-M----?--B----o---------MB-----?-E-----B------------M-----o-M-------B--------B-----B----?----??--oB-?M-?--?--------M-?-o------o--M---B----?---B-E--?--------B--------M-?oM----?E------o--
---o-----------M-------B---E---MEB----M----B------?--M-M--M-----EB-----------------------------B-------o----------o----E----ooB---E-B---M--E-M-----o----M----E---B------B-----------M?-M---o----BB-M-?--
-oB----B--B?-B-?-------B-?----------------B-------------MB----oE-----------B--M---?o---MEM-----------B-----?--?--o--E-B--E-----------o-----B---M----E----------------------------oM------B-----o--------
--B----o---M---M?---------o-o-----B---M-----B----BE--o-E----M---o--------B---Bo-EE--------B----o---E---------?M--B-------o---oM-?-------o-?M---M-B---?----------M--M-----M-------M----------o--o---?----
-B----------M?-E-------o--E--E-------M-------o-o--o------M---------------E---------------?E---------?------?-------ME------MB-E---o---?---B-E?------?-------Bo----?-E---o------E-B----B-EM----?----B---v
-?-----------------------ME----------BB--?---B-----------------B-------?---------M----E-?--?----EM---------------?-------M--B---M-----?-M---------E-------?---------o--------------E?M------B----------f
------M----------EE-----MM------------------M------EM----Boo--?---M--M?----B-MB------------------o--------------Bo------B-o-----M----------o---Mo----------------------B-------------?E-B-----??-----M-f
-M----E-------o---------B----M--------E--o-B----?-------M--o-M------B-----?-o------oE--M------o-----o-------M--ME-------B---E-----M------E-----------?E--?---M---?----o-----------M-E---M----o-?--o----f
-M-o------------o--MMB----------BB-M------o--------?--?B-M--------B--B--M-------------o-?-E?--?-------B--E-?-B-----------E---------------B-M-------MMMM---------E-----B---E?B---?--------?-B------M--?-f
---------------M--B--B----ME-?MM?------------------B----E-------M---o-E-------?---oo--?---?B--ooM----M----?-?---------E?-------M-----B-E--------ooM-------------B----E----------??-M------MoB--B-------f
----E--o-?-B-----E?--E-----M-M--EB-?----M-Mo------Eo-o----------?------B-----B-----B--B---o--B-E--B-------o---------B-----?----M-----?---M--?oBE--?---M-----M------B-?---o--B--E--?---o--?-o------BM---f
mE---------?---M?-----?------------XB--------?B--E-----B---E-------o-----------M----------|----?---MB--M---?---------E-|---o-E-----M--|X----?--E---oo|?--|---?--X-M-------X|---E-----------|-E-|-E-----X
XXXXXXXXXXXXXXXXXXXXXXXXXXXXXXXXXXXXXXXXXXXXXXXXXXXXXXXXXXXXXXXXXXXXXXXXXXXXXXXXXXXXXXXXXXXXXXXXXXXXXXXXXXXXXXXXXXXXXXXXXXXXXXXXXXXXXXXXXXXXXXXXXXXXXXXXXXXXXXXXXXXXXXXXXXXXXXXXXXXXXXXXXXXXXXXXXXXXXXXX
