--------------------------------------------------------------------------------------------------------------------------------------------------------------------------------------------------------
--------------------------------------------------------------------------------------------------------------------------------------------------------------------------------------------------------
--------------------------------------------------------------------------------------------------------------------------------------------------------------------------------------------------------
--------------------------------------------------------------------------------------------------------------------------------------------------------------------------------------------------------
--------------------------------------------------------------------------------------------------------------------------------------------------------------------------------------------------------
--------------------------------------------------------------------------------------------------------------------------------------------------------------------------------------------------------
--------------------------------------------------------------------------------------------------------------------------------------------------------------------------------------------------------
-------------------------------------------------------------------------------------------------------------------------------------------------------------------------------------------------------v
--------------------------------------------------------------------------------------------------------------------------------------------------------------------------------------------------------
--?-Mo--EM?MB--EM----E------oB-oM---------B-----------o-B-?-B---------B-E--M--B-oM---M--?--oE---------M-MB------oB--------E--MMB-B---??-B-E?-M-??------M------------?-oBB-----E-E--oEE-?----BM--o--o----
-B------o----?-Eo-------B----o------?---------------------E---E----------EB------B-----B-E?---Eo------B-----------o-E---B------?-o-E-?-??---?--?--E-Mo--o----oo--------E?---o---------B--?-EE-MM---?o---
--M-----B---oE-X-E--B---M------M------M-----?--?----B--M-?-E------B?--------B--?X-o------------?--?------------------BBX--E--o----o-o----------B---o----M--??--?--M----oX-----E-?o--E--o---M------E-EE--
-?-B-BE---------Xooo-E---------ME-E-----------o-----X-B---X?-B------?--E-------BMXM-----B--?--B---ooo----BB------?M----X-----------EB--E--B-----Eo?o--------X----M--E---X-o--XoX---E---?--?B--o--?o-----
---BB-?--?X---?-X---oX---?-X?o--------o-----------B-oX----XoBo-----?-o-?Xo--X----X---o---Bo--o------??---MBo---oM-----X-XM-------BE---M-?-----B-----X---B?--XM---------X--?-EEXo----M---E---o---X?------
m-X-MXo----XX-X-XMEMXo--oX-X----B-?BB----o?B----------Xo--BXX-X-B-BX--oXX-XEMX--M-X-o--E-BX-----E---?X-X-E-XE--XEE--oMX-XX?EX--BX?---B?-MEEEM-M-----MX?--M--XXB----Mo--?X--X-XX-E------?o--o-EM?XooX----
XXXXXXXXXXXXXXXXXXXXXXXXXXXXXXXXXXXXXXXXXXXXXXXXXXXXXXXXXXXXXXXXXXXXXXXXXXXXXXXXXXXXXXXXXXXXXXXXXXXXXXXXXXXXXXXXXXXXXXXXXXXXXXXXXXXXXXXXXXXXXXXXXXXXXXXXXXXXXXXXXXXXXXXXXXXXXXXXXXXXXXXXXXXXXXXXXXXXXXXX
