--------------------------------------------------------------------------------------------------------------------------------------------------------------------------------------------------------
--------------------------------------------------------------------------------------------------------------------------------------------------------------------------------------------------------
--------------------------------------------------------------------------------------------------------------------------------------------------------------------------------------------------------
--------------------------------------------------------------------------------------------------------------------------------------------------------------------------------------------------------
--------------------------------------------------------------------------------------------------------------------------------------------------------------------------------------------------------
--------------------------------------------------------------------------------------------------------------------------------------------------------------------------------------------------------
--------------------------------------------------------------------------------------------------------------------------------------------------------------------------------------------------------
-------------------------------------------------------------------------------------------------------------------------------------------------------------------------------------------------------v
--------------------------------------------------------------------------------------------------------------------------------------------------------------------------------------------------------
--------?--o--E-?------?------?---X-------E-X----Xo-----XXX------?X-------o-?--?--------oX-X---XX-XX--o--o?--?o-----E----XX----?--o-------------?E--------------??--------X-X---E---??----X-?-X---------
--?o--??--------o--o--------------EX-------?-X-XX-E-X---X--X-E----X---?---o----?Eo------?XX--?-X-XX---------?---o-??--??-X-----?----?-----?-----o---?---E-----------o--o?XXX--E----E------X---X?-E-o?E--
------o-------E-?---?-------------X--Eo---EE-XX-X?-X-??-X-X--------X-----XE----?-----?--XX----X---XE------EE-----------?-Xo-------oE-------XX---o-E----------?---E-----E?XXooo-?-?--------X-XX----?-----
-----?o-E--?--o--------?--o-T?---?oXXE-?--XoX-XEX-XX--XEXXX-E-----E-X?---X-----?----E---Xo?---EX?X--E--E--X?EX-----X-X--??X?-?----oXo-?-?-o-X----???o------X------?-?----?X-?---o-------?-?XX-----------
-----X-X-?-E---?-?-o--X-T--o|o?-T---X-----oX--?Xo-XEXX-XX-XX----?-XX?---X---E---E-?o----Xo?X???-Xo-ToETE--EXoX------XX-X?o?XXX-----oX-E?-oE--X-o----?X--TTX--Xo?---T-----X----??X-ooE-oEEo-X--?T--------
m-???XX|EE?-o---?-X---X-|-?-|---|X---XX?---X-X-?X--X-X-X-?XXXX--?-X--X-o-XX-?-----|X-Xo--XX-||XXX-o||-||X-X|X-?o--X|XX--X-E?XXXX-?--XX|X-X--X-X-?--XX??X||X--|X-o-E|-o-?XX--XX-X-?--|-||XXX-XX-|o??-?X--
XXXXXXXXXXXXXXXXXXXXXXXXXXXXXXXXXXXXXXXXXXXXXXXXXXXXXXXXXXXXXXXXXXXXXXXXXXXXXXXXXXXXXXXXXXXXXXXXXXXXXXXXXXXXXXXXXXXXXXXXXXXXXXXXXXXXXXXXXXXXXXXXXXXXXXXXXXXXXXXXXXXXXXXXXXXXXXXXXXXXXXXXXXXXXXXXXXXXXXXX
