----------------------------o------E-------------------?--?----E?---------------?---o--o---------E-------E-------?----------E---------E---------?-------------o-----------E--------------------------E--
----------------------------o--------E---?---------E-----------------------------------------------------------------------E--------?---------o---------------------------??----------------------------
--?--?------------??-------------?--------------------------o----E---E-------?------------------------------?--------o-------------------------------------E-?---------?-------?--E----o--?-------------
--o-------------?-----?----------------?--------------------------?--------------------E--------------?E------?---------------------------------?-------?------?-----------------o------------------o---
------E-----?---------------?------------------------------o--------E-----------o--------------------E--------------------------?------------------------o-----------------E------?-------?---?----?--o-
--------?o?--------o----?--?-?-------------------?---------------?----------?---E-------E-----------?---?--o---?-------?-----------------E------?--------------??--------?--------?--------?------------
--?--------?-----------------------------o------------??--E----------------------?-----------------?------------------------------o----?---?-------------?----E--------------------?--E-----------------
---------------?--------E-o--o--?-?---------o------------------------------------?---------?---------o----?-----E-----------------------------?---?---------------?------E---------------?---------?-?-v
---------------?--------?--E-------------------------E----?---o--------------------------------------?----o--------------------E--E----?---------------?--------------------------------E--------------f
-------------------------o--------------o----------?-----?-------------E---------o-------------------?------E-----------------------------------------E--------------------?--------o---------------E-?f
--------------------E------------E-------------o-------------------------------------?-----?---?----------------------------E---E---E--E-----------------------------------------E-------------------E-f
----o------------?-----------o-------------------------?--------?-------?----E?-----?--------------------E------------------------------------?-------------------?----------------o-----?-------?-?---f
-------E------------------------?---E------------------o---------E-------------------?--?---------o--------------------------?-----------------------------------E----------?-?o-----?--------o-------?f
-----E--o----?--?---------------------?-----------------?---------?----E----------------------------------------------------o--------E------|------?-o------------E----------------o----E--?--|--------f
m--o--------||--|---|------?--|--|---||------?|--|-|||----E--------|?|-|-||----?-|-|-|--|-----------||-|--|--?|----||---?----o||---------?--|---------E---E------|---|-?-o-------|-----|-|---E|-------|X
XXXXXXXXXXXXXXXXXXXXXXXXXXXXXXXXXXXXXXXXXXXXXXXXXXXXXXXXXXXXXXXXXXXXXXXXXXXXXXXXXXXXXXXXXXXXXXXXXXXXXXXXXXXXXXXXXXXXXXXXXXXXXXXXXXXXXXXXXXXXXXXXXXXXXXXXXXXXXXXXXXXXXXXXXXXXXXXXXXXXXXXXXXXXXXXXXXXXXXXX
