--------------------------------------------------------------------------------------------------------------------------------------------------------------------------------------------------------
-------------------------o----------o-------------------------------------------------------------------------------------?-----------------------E-------o-------------------------------o-----o-------
-----------------------------------------------------------------------------------------------------------------------------------?---------------E----------------------------------------------------
----------E---------------------------------------------------------------------------------------------------------------------------------------------E------------------------------------?----------
------------------o---------------------?-----------?---------------------------------------------------------------------------------------------------------------------------------------------------
------------------------------------------------o-E--E--------??---------------------------------------------------------------------------------------------?---------------------------------o--------
----o-------------------------------------------------------------?--------E------------------o------------------------------------------------?-----?---------------?---------------------?--?---------
---------------------------------------------------?------------E---------------?--------------------?-----------?--------------------------------o------------?--?----?-------------------------------v
---------------E----------------------------------------------------------------------------------o------------------------?--------------------------?------------------------------?------------------
--???---?--o?--E----E-------?--------E?---------?-o-------------------???------o-------?----o------?--?--o?------------------------?-?o----------?E--------o-?-?-----o-----o---?o-------?---?--o--?-----
--o--------E-?---oo--??-E-E----o--------E--?-o----------------?-o--E---------?--?o----?-E?--oE---o-o----?-------------?-?---?--?------?-------oo-----------?---------------E-?-E---??----oE-----o-------
--o--------------------o------o-----o?------E--------?----------------------------E--E-o--o----o?----?--------o----EE-?---o-----?E--------?E----E------E---?-?--?--o----?-----o--E---------?-?-?-o---?T-
-E-----E---o?-??---?-Eo?---?---------E--E--E----E----E-------o--------EE--?o----------E-----------o-EE--o-Eo---------o-?--o----??----o------E---------?E--------?---?---?Eo--------?--o------E-?-?----|-
-----T-----T---------------T-T---T--TET--o-E--E----------?---?-??-------EX--?----T---------?--T---o-T---o-?--?--?-----T-?-T--o-?E----o-----T?------?-?o-E------?----?---E|?-----o----o---?o----ET---E-|-
m----|-----|--------?-?o---|-oE--|--|||----------o----?o---?o---|XE----?-X-?-E---|----------E-|---E-|-----X--|---o?-?-|o--|----------E?----|------o----------?--??---o----------|--E-?----------|--?--|-
XXXX-XXX-XX-XXXXXXX-XXXXXXX?XXXXXXX-XXXXXXX--XXXXXXXXoXXXXXXXXXX-XX-XXXXXXXXXXXXXXX-XXXX-XXXXXXXXXXXX-XXXXXXXXXXXXXXXX-XXX-XXXXXXXXXXX-XXXXXXXXXXXXXX----XXX-X-XXXXXXXX-XXXXXXXXXXX--XXXXXXXX-XXX-XXXXXX
