--------------------------------------------------------------------------------------------------------------------------------------------------------------------------------------------------------
----o-----------B-----E---------------------B---------M----------------B----M------------------------?---E-----------------MM-----------o----------------------------------BB---------------------------
--------------------oM--------------------M--M--M-----?-----------------------E--M---B-----------?---E---------E----EM------B----------------------------------------------------E-B---M----------------
---o------------------M-----------------------------------------o---------E-------------o---------------------B--------------------------M----------------B---------------------------------------------
---------------------M-B-------------B-----------B-?-o-----------B--o---B------------------------------------------E--?---------------------------------------------------------------------------------
---------------------E-------------------------------------?--------------?------B---------------o--------M--M-----B-------------B-------------------B-----B----?-----o---------------------------------
--?------------B---------------------------------------E---------------------?--------o---o----------------B----B----o--------------------E----B----------------------o--------M--E---------------------
------------------------o---B-----------------?--o-----------------?---o---------o--o--E---------o-----------------B--------o---------------------o----B--------------------------------E--------------v
-----?------------------------------------X-----------?----M----M----------------?----------B-MB------o-------------------BB-------------M----------------------Mo---------?---o--E--------------------f
---EM----ME------------E-MM---E-----------XXE--o-----?----M---E-?-o-o-B----E-B----oBE------B-?---------E-------o-----?M--EE----E---M----?---M----XX--?--o--E---o-oE?-----B?-?---------------?o---------f
-B------------o-o------o-----B-----------B?X-?B-o---------M--?EMX-MoB---M--E--MM------M-?-----------M--------E?----M--E--E--?----------B--o---o-X-?o-oo---B-o----B---------M-------EB----?o?-----------f
----B----B---------?--E?---------M--------E-?---B-B--------oB----X-------------?-----------EE----------?---E---?B------oE--------B---M------BX--X-E----E-T--B------X-----MT--?E-------M-E--------------f
--MT-------B--o--TBE---------------------E?XTTo-----ET-M-M---o--EX-E----------M-M---BM----E--?---------Bo--EB--T---Eo--ET-BT-oM-?-M-X------EX?-XEo--T----|--M----?--XB-X?-|---?----?E--?T-oooE---------f
---|T-MBo-Mo----?|T-ET-TMTT-XX---T-oBM?BB--T||---ETM-|--TX--Bo---XB?-T-TTE-----X--o-?XMo-T-XX-XM-M--------T-TT-|-TTo--?MTB-|----T--XXB-XETM---BX?o--|----|--TE----?TT-X---|-T-MMT--T-ET-|-oX-----------f
m--||------XX----||--||--||-oXX--|------BX-||---BX|B-|--XoXX---|-X|--|-||-----X----------|--X?X----|------X-||-X--|-X---|-B|--|----?X---B|-----X----|----|--|--B--B||-X-BX|-|--X|-X|--MB||-X-----------X
XXXXXXXXXXXXXXXXXXXXXXXXXXXXXXXXXXXXXXXXXXXXXXXXXXXXXXXXXXXXXXXXXXXXXXXXXXXXXXXXXXXXXXXXXXXXXXXXXXXXXXXXXXXXXXXXXXXXXXXXXXXXXXXXXXXXXXXXXXXXXXXXXXXXXXXXXXXXXXXXXXXXXXXXXXXXXXXXXXXXXXXXXXXXXXXXXXXXXXXX
