TT---M-|BXo----TX----BMMT|oX--?---|---ToB-?|-B--E--XXXTB-MT-T--|MBT-E---EX-B---oMoEXE--TM----?M-BT--?-?-X-----BT?--------BE---o--|T-oo-EE--TM-X-|---T-X-X--|-E-E-|TM-XT---BX--TE--TE-BEX---MTX----M|--?B
oMEo-B|-T----T-|B--M----To-----MBo-T--T---TE-----B----?B--TX--Mo---XE--|-?BXM-MB-X?-T-Eo--o-?|-XB-o|T----T|T|?--Bo-X-?---X------M----E---------M-M?---BT---MX|-|----||-E-?|-T--BBB-B?-|--o?-|X-|BB----B?
B---o--o-------?--------BX-----|-|TM-|-E------------------B-XM----o|-XMT----|--o-T-EX?E-|--|?----X-?---BX--------BTM--T?T-|ToT--B-XMX-----E?|-|B-TE--E----Eo-o-o-EB--E--Mo-B-TM---BT|-Mo-|BoE--------MMT
B?----?EoooE-M--E------X--X--BME?o-BoM-o--|--BX-oTXEX----XMTo--Mo-E-M-||---M?--M?-o-----B---?E----X--o|-T--Xoo-X-T--|B?-?T---ooTE-BM--Xo---|E----M--o----M-X----B----|-XX-M-----X--------B-----B-ETE--M-
o-To-BEEE----T|----E|B---o---BTMBMX----X---?-TE--?-TEB---oE-E--X|---TX--XXXB-X-M--M--|T--TB--oX--T-E---|oE-T-|--T|X-M--|XE--B----M--?--o---MB?---o-M-o-BB---EMT?E-?-T----M---?-|-TB--?M--T-XT----oE----o
oB---B|-B||--E-o--o-----MB-XBX-BB-?-BE-o-----------T-BT-?-------oo---|---?M---M-B-------o----|?-XMX----E-E--?---?--?|---?---oEoTo-E?-?--------?M|BT-E---o|XT?--B--M--E-X-?-------oEM----M----|---BE----E
|-XE-?MX-----B--B---X-X--?-E-E--?|-------E-?-|-E--BB?T-o---o---MMT----XBT--EE----|X--E--?------X----E-oM-?--|--?M--XT?|-E-B-M-MoT--XBoT-B--o---TT-------o-EEEo-|--o---BMM--|Eo|E-?--XMB-XME-B-|--?---Moo
|BM-B---XT--|----M|XB|TE-T-??E-o-o-XoBM----?--?-B--E-EMTM-MMTB-oX---E-M------M-|-Xo--T--E-T-o----M-|--M-E--?XEMoXE-E--?-|-|BoEB-|-E|?-?T-o|-TT-------M-----X-?-B-----|-BE----B------------?X----BB----?v
-TBEE-X----To-|--M--E--T-----||-----o---B-BX---ME?-B--MTX?|Bo-X-E-B--MT--o?-|--T?MM---EMXEo---TEE--X--XoM-T----E?-oo|T-ME--E--B-M-o-X-----o?BE-MXBET---EX-MB--M?----?Mo---To|BBE--o---|-------X-M-|-?-E-
MT-XM--M----oo--T-------T|M|T|-----o-E-M-|M----E?--o-E----?E|--MoE---To-E--X-Bo-----E--o--TBX-XXM----T------o---X?XXMT---B-----BMME--BB?-|-|?-|o-TB---MM|--XB-T---MB-----B?Mo--BT---TXEoX----?---oX--?EE
E--E--o?oMXB-T-?-------?MM--?-E-E-|--|--Bo-?----|X--|-M--E-E-E----|BM-----T--E--M-|???--|-MX-??--|-|---ME---oEo--B---o--X--ToB-?o---EX-o|---------MBME-----TM---?---ET--BE?-E-|B?MMEB-------X---oEX|-o--
-------oETBE|------T--Mo---EB--o---?E-MT|-X|BM-X----?---T---------------oo---EM-?T-?--T-X-------B?T--?|-|B-|M--EX---B--o--EM-T?MX-o?-T--M--M--------TE-B---?--TT---TM-B-----E--X-o|-X-?-M-X--|B-MM---X-T
E|--|?-|oB?MT-E?|B-T?Eo?----oE---T-----B--EE--X?-M-----o-?o--EM-|---XEMT-E-XEETo--B-X-oX--X|T--?B--XM-X-TM?--B-B---???---o-o?T-o---oTX--E--X---E?o----?T-|-|-E|--|BT-oX-T-B-B-?---||-T-E-----M?--|-T-MoE
?-|-?--T--B-B?|--?B-XT|---M-|ME-?BE--M-MB-?--X----?oB--------M-T--oEEo--X--|--T--|T?---M|-E--X-|-MB---o?-o-M--T---|---?|EEo|B-?----MX--|T---?-|B-B-------XBMo--------?-----TB|o?-X--|TM-ETE-EX-----?MBoE
m-TM----|B-------M-o-EB?-TBo-----|E--ET---oo----o|-|-T-|--M---To-TT-?o-EBM---|Eo----BBB||T---|------?-TT-?----Xo-BB------------BE----B----T-XE-X-o-o----?B---|-E--BX--?B--E----XEB----E---E-BT-E-----|B-
XXXXXXXXXXXXXXXXXXXXXXXXXXXXXXXXXXXXXXXXXXXXXXXXXXXXXXXXXXXXXXXXXXXXXXXXXXXXXXXXXXXXXXXXXXXXXXXXXXXXXXXXXXXXXXXXXXXXXXXXXXXXXXXXXXXXXXXXXXXXXXXXXXXXXXXXXXXXXXXXXXXXXXXXXXXXXXXXXXXXXXXXXXXXXXXXXXXXXXXX
