----------------------o---------------------------------------------------------------------------------------------------------------------------------------------------------------------?-----------
------------o----------?-------------------------------------------------------------------E--?---------------------------------------------------------------------------------------------------------
-o---------------------------------------------E------------------------------------------o-----------------------------------------------?----?--------------------------------------------E------o----
---------------?--------------------------------------------------?--------------------------E?-------------?------?E------------?-------------------?---------?--------------------------o-------------
-----------------------------?-?-------------------------------------?-----------??-------------------------------------------------------------------?---------------------------------------------o---
-------------------------------------?---------------------------------------------------------o-o----------------?------?---------------o---------------?-?--------?--------o?-------------------------
---E-------------------?----------------------------------------------------------------?-------------------------------------------o--------------?---?-??-------E---------------------------E---------
-------?-----------?--------o--------------------------------------?----------------?-----------?---?---------------------E-------------------------??-------------------------------------------------v
-E-------------------------E-------------------?---------o--------------?-----------------E-------------------------------------------------------------------------?-?--------------------------------f
-------------E-----?-----------------------------------------------E-----------------------------------------?-----------------------------------------------------------------------------------------f
----------------------------?--------------------------------?-----------------------o----------------o-------------------o-------------------------------?----------------------------?---------------f
-----------------o---------------------------?----------------E------------------------------------------?----------?-E--------------------------o-------------?---------------------------------------f
-------------------------------E---------------?---------------------------------------------------------------?----------E--------------------------------------------------------------?---?---------f
--------------------?-----------E----------------------------------------------------------------------------------------?----o--------------------------------?---------------------------------------f
m--o---------------E----o-E------?---------------------------Xo------------o------------------|-?--X------------------?----|------?--------------------X---X-----------------------------------------o-X
XXXXXXXXXXXXXXXXXXXXXXXXXXXXXXXXXXXXXXXXXXXXXXXXXXXXXXXXXXXXXXXXXXXXXXXXXXXXXXXXXXXXXXXXXXXXXXXXXXXXXXXXXXXXXXXXXXXXXXXXXXXXXXXXXXXXXXXXXXXXXXXXXXXXXXXXXXXXXXXXXXXXXXXXXXXXXXXXXXXXXXXXXXXXXXXXXXXXXXXX
