--------------------------------------------------------------------------------------------------------------------------------------------------------------------------------------------------------
-----B-----------------------------------------------------------------?----------------------M---------------------------M----------------------E-M-----B----------------------------------------------
------?----------------------------------------E--------------------E---------------------------o?------------------------------------------------------o-----------------------------------------------
----?-----------M-------------------------E-----------------------------------?--------------------------------------------------------------------M-----------E--B------M------------?---------B-------
--------------------------------------------------------------E-?----------?-----M--------E---------B----------------------M------------------------E----------M-------------B---?-----------------M----
-------?----------------------?------------------------------o------------------o--------------------------------------------------------------------E--------------------------------------------------
-----------MM-----------------M---E-----M------------------B----------------E--------------------------------------B-----?-------------------------------------------------------------------?----------
-------------------------------------------------------------------------E---------------------B-----------B---------------o--?------------------?---------E--B------------------M-B-------------------v
--------------B----------B-----------------------------------------------------------??o-------------------------------B--------------------------------------------------------------------------------
-E-----o--?-E--?-----M--------?-o--?----X-M----------B------?-E-E-?-M-E------------XE-Bo-----?-?-M------M--------?------E--M-M---------o----M--?-E-?-?-----o---?------?------?-------?oE-?-oB--E-M?-M---
-------B-E---o------------------EB-----XEo--E----------M----?-o----??-o-M-M-E-------XXX--E-----o------B-----M---B---B-M--E--?B---M----------B--------?-----E--?B--------M----E-------?E----------??--M--
------M-E--o-M-?-----EBB---E-X-o---??-X---B-?----------E--------------X---E?-----o?-o--X?------o---M----?B-M--------B--?-M-B-?-------Bo-B-------?-----o--?------?--o-o----MM-o----EM---M-----o-----BM---
------o---o--------B-?X----XX-E--X-XoXX----X---B-?---X-X-E------E---?-XB-M--E---------X---M------EMMo-----EE--B--?E---?--B-EXXXXoo-B----BX------?---o-M--X-B-M-------XB-----X---?-MX---EB---X-B?-----M--
--??-B-X-M----o--?E-XoX--M--XEo--BX---XoX---XM---o---EX-MEX-?--XoX--?-XoEo----E-B---B--X---------------M-------X--?X----E----XBXX-M-----XX--M--B--B--MXXX-BB---?B-oM-Xo--?EX-M-B-XX---X-E--X---MEE--oE--
mEE---XX-?-Eo-XX?-X-XX--X-E-XM?X-X--oX--X-oXXB|o--B-X---X-?-?-BXXo-?--oX-M-B-X---X-----XM--MM-----o------------EB-X------?BX--XM--Eo--X-X--Xo--?B------X----XM--BXX-XX-M--X|X-XX-MXXM-X-X-X-E-X-X-M-o---
XXXXXXXXXXXXXXXXXXXXXXXXXXXXXXXXXXXXXXXXXXXXXXXXXXXXXXXXXXXXXXXXXXXXXXXXXXXXXXXXXXXXXXXXXXXXXXXXXXXXXXXXXXXXXXXXXXXXXXXXXXXXXXXXXXXXXXXXXXXXXXXXXXXXXXXXXXXXXXXXXXXXXXXXXXXXXXXXXXXXXXXXXXXXXXXXXXXXXXXX
