--------------------------------------------------------------------------------------------------------------------------------------------------------------------------------------------------------
---B------------------------------------------------------------------------------------------B------------------------------------------E----E---------------------------------E-----------------------
------M---------------B--------------------------M----------------------E---------------------M-------------------o--------------------------------o---E-----------------------------B------------------
---------------------?----------o---------------------------------B--------------?----------------------------------B----------M------E-----B-----------------------------------------------------------
--------------------------------------------o-----------------E-----------------------------------------------------------------------------------------------M-----------------B-----------------------
--B----------------------------------o----B-----------------------B----------------------B------------------B-B-E--------------E----E-----B-------------------------------------------------------------
---E------B--------------------------------------------------E---------------------------E-----------E-B----------?-------------------------------------------------------------------------?-----------
------------------------------------------------------------------------------------------------------?------------M--------------?---------B----B--------------------------------------B--------------v
---------M?-------------------------------------B-------------------B---------------------------------B---E--------------------------------o---------------------E-------------B------------------------
--o-?E------?-X---------?-oo------M---X-B-------EMo-------B--?M-E---?-BM------B------?-----?-B----o-------?---o----E?-----------B?---o------o-oMB--------M-?--EoXX-BE-ooo--?E------M--E-B-----oo--------
-M--M-?---M---BE---o--EB---M----M-oM---XX----o---M-o--M--------M--B---o---?--M----B---BMM?Eo--------M?---------Mo-M--B--B-EX--M--E--o-----------B-o----------X-XX-------o-----E---B-E--M---B----B-------
----oB-MB-oB--X?-----M-?--E---o-Xo-oM--MX-X----o-------?-----M-Eo-EE--?o-----M------------o-M-E--o--MBE-BEE---------?-----X-?-?-??E---E-o--?---oo----ooB---M--XX-X-X------E-B--o----?-B--------?--?--B--
-E-M--BE?--E-X?-?-B-MXX--X--XM-X--------XX---oX----o--o--?---M-oBE-??ooM--?---------Bo----BBo------?-----XXX-M-EM--------EXX---B-o--XXXB-o---?--E---XE----?--XX--EXX-------?----E?-MB--B-B-E------o--M--
---M--------EX-E----BoX--?X-X-X-MBEM---EX-MB?X--BMX--M-?M---oX---M--oE?----B-B----oEX-------o---X--oE----?Xo--B------M-o?XXXX-M?-?-oE---?---X--BB?XMX-------XXM---XM------?----X-E----o-???E--o--?-o-o--
mo?Eoo--X--MB-XEE--X--X-??BXXX-o--BX?XBXX--BE-XB--oX?--oXXMXXo--oXE-X-XXo-o--?M?-oE-X--BE--MX--X-E---ME---o-o-----BMXXXo?XoMXM--X?-MXX------XE--XX---XX?BX---XM-MM|XX?E--?--ME-XX-X--X-oXMXE--XX---??E--
XXXXXXXXXXXXXXXXXXXXXXXXXXXXXXXXXXXXXXXXXXXXXXXXXXXXXXXXXXXXXXXXXXXXXXXXXXXXXXXXXXXXXXXXXXXXXXXXXXXXXXXXXXXXXXXXXXXXXXXXXXXXXXXXXXXXXXXXXXXXXXXXXXXXXXXXXXXXXXXXXXXXXXXXXXXXXXXXXXXXXXXXXXXXXXXXXXXXXXXX
