----Eo----------o------E----------------?----------------------E------------------?------------------E-------------------o-?-----o------------E------------------o-------------o----?--E----?--E-?------
---?----------------------------E----------?-----------?------------------o-----?---?----E---------o--E------E-----------E---------------?--?--------E?--o-----------------------------?----------------
-E--------o-o------o---------------------o---------------o-----?----------------------------------E--------------------------------?-oo-o------------------E----o-------------o----------------------?--
-E-----?-?------E-------------------------------------E----------?------------------?----------------------------------------------------o-----E-------o---E------?o-----------------------------o------
-----E----------------o-------?-----?-E---------------?-----?----------E-?----?-------------------o------------------------------------?-----E------?--?------------------??--------------------?-------
---------E-?---?-----------?--------?------------------------?-?-?-----?---------?E---??-------E-E-------------------------------------------?------------?--------?-------------?-----------------?-?--
------------------?----------------?o--------------?--------?----------------------E?----------------o-----?----------?---------------------------E?-?--------------------o-----------------------------
------------------------------------------------------------------------------?---E-------------?--?---------E-??-----?------------------------------------E-?-----------------------------------o-----v
------oE-----?E--------o?-------E-------------------------------------------------E-------------------o---??-----------------Eo--------??----?-----------------oE--?--o-----------------E?---o---------f
---------------?---------------?-----------------------?--oo-----??-----??---E------o------------?----------?-----------?------------------------------------------------------?---------------E-------f
----------------o----?EE-----------------o---------------------------------------E-------------E-----------?-----------o------o---------------?--------------?-----o------------E---E-o----------------f
------o--------------?---------?----------o---------E---?-----o-----------oE-------?----------------?--?-----E------------o----o------?---------------------------------------------?------------------f
------------?--?-o----?-----------?------?--------------o----?-------?-------o-----------?-----------------?----------------------o-----------------------?---o--------------------E-?-----------o-----f
---------------------o--E--------------------------------o---o---------o-----|-----------|-o-----------------E-----E---------------------Eo--T----------------?------------?-----?----------?---o-?----f
m-------||----o?--|---------|-------o?--||-----|-----|--o------|-?|--|---||--||-------o-||-||------|----|-|-------------|-E-|--|-E--|-|E?-|-||-------o-----------------E|--------------|----|-------?-?X
XXXXXXXXXXXXXXXXXXXXXXXXXXXXXXXXXXXXXXXXXXXXXXXXXXXXXXXXXXXXXXXXXXXXXXXXXXXXXXXXXXXXXXXXXXXXXXXXXXXXXXXXXXXXXXXXXXXXXXXXXXXXXXXXXXXXXXXXXXXXXXXXXXXXXXXXXXXXXXXXXXXXXXXXXXXXXXXXXXXXXXXXXXXXXXXXXXXXXXXX
