----------------------------------------------o--?-------------------------------------------------------------------------------------------------------------E----------------------------------------
---------------?----------------------------------------------------------------------------------------------?----------------?-----------------------o-------------------?---------E------------------
---------------------o------------------?-------------?-------------E--------------------------------------------------------------------------------------------------------------------------------E--
--?----------------------?------------------------------------------------------------------------------------o-------------------------------------------------?----------------------------------E----
-----------------E-------------?-----------------?---------------------------------------o--------------?-?-----?----------------------------------?--?-------------------------------------o-----------
-----------------------------------------------------------?-----------------------------------------------?-----------------------------?--------------------------------------------------------------
---------------------------------------E---------------------?-----o--------------------?-------?--------------------o--------------------------------------------------?-----?-------------------------
----------------------------------------------------------------------------------------------?------E-----------?-----------------------------------------------------------------------------------?-v
--E-------------------??-------------------------------------------E--------o--------------------------------------------------------------------------------------------------------------------------f
----?-----------------------------------------------o--------------------------------------o---------------------------------------------?----------------------------------------E--------------------f
---------------------------------o--------------------?----?-----------------------E------------?------------------------------------------------------------------------?----o------------------------f
---------------------------------------------------------------------------------------------------------------------------------------------------------------------o---------------------------------f
------------------------?---------------------------------------------------------------------------------------------------------------------------------------------------?-----------E---?----------f
--------o-----------------------------------------------------------------------------------------------o----------------------------?-----------------------------------------------------o-----------f
m-------X-------------------------------E----------X---------X-X--------------------------X---X-------X----X--X------------X---?--X-----XX----------------EE----------------------------X------------?XX
XXXXXXXXXXXXXXXXXXXXXXXXXXXXXXXXXXXXXXXXXXXXXXXXXXXXXXXXXXXXXXXXXXXXXXXXXXXXXXXXXXXXXXXXXXXXXXXXXXXXXXXXXXXXXXXXXXXXXXXXXXXXXXXXXXXXXXXXXXXXXXXXXXXXXXXXXXXXXXXXXXXXXXXXXXXXXXXXXXXXXXXXXXXXXXXXXXXXXXXX
