--------------------------------------------------------------------------------------------------------------------------------------------------------------------------------------------------------
------B------------------M--M------------B------------------------------o-----------------------------o-----------------o---------B----------o-B------------------E----M--------------E-----------------
-------------------------------------E-----------B---------------------------------------------------------------------o--------------------------------------------------o?----------------------------
------------B--------------------E-----M-------------------------------M--------------------EB------?M--------------------MM-----------------B--M-B------E-----------M-?--------------------------------
-E----B--------B-----------------E-----E-o----------------B---------------------B-----B--o------------------------------------------E----------E--------B---M------E-----------------M------o-----------
---------E----B--------o---------------?--------o--------------------------------E--------------B-----M----------?----?-------------E-?-----M-------------------------------------------o---------------
----------------?-------------------------------M------------B--?---------------------------------Bo--B----?E------------------------?---------------------?-----------------------------E--------------
--------B?----------------E---------------------B--------------------o---E--------------------------------B-----------------------E-----------------?o---B------B--B---o-B---------E-------------------v
------------------------------------------B--------?--Eo-------------------------?------------?--------------------B------------M------E------X--?---------------------------------------B-------------f
-?---BB--?-----?-B?M--M------------oo--o---o-EMEoM---------------MB------?E--E---o------M-?---------Eo----------o-M------E---------?------o---X?o-------B--MB---B--oM---BBM-?---?-?--E?--E-B-?---------f
------M?-M----------E-----o-o-----M---B--oM--B-o-----B--B--o---------E---o-o--?---?M---B?---?--BM-----E--?----M-----?M-----E--?-----B------MX-E--o-M-----?-o---B---M---o--E-MT-----?----Eo-------------f
-----E---------MM-----?--B----------M----?B-oBM-B---oE-----E--------X---BM------XX-----XX---o-----o----B-------?ET--?X-----?--M-B--o---T----XX--MM-------o---?--E---------XB-|--T---o-?----------------f
----X----M-E----E-------M-M---------------?--XXBo---------B-M------X------?--B----o----X---M---o--M---o---?---X-X|---X--M--------BX----|-o---X-M-?----B-----M-?-o-----Eo-X---|--|---E----T--?----------f
--MXo---T-TT-??-M----B---o-TMTT---TM--E-MT-MXEX----o--TX-TT--XBT--|-?----TMo|-TTX-----ToX--TM--B-TTo--MT--T-o--XB|-XXXX--B-----o-X-BX-MT-BT--XTE------E--T--B-E-T-T---XoX-B---T?|BTToT--?T-TMT---------f
m---X-|---|------X--B---XX-|--|---|-MB---|---X|--X---X|-X|||-XX|--|--X---|--|--|-oX-|-|?-XB|-----||----|-----X-XX|-XXXXX--X-X----X--|-X|-X|-X?oB-B--XB---X-------------X-X?|-X|-|-||-|---|-|-|---------X
XXXXXXXXXXXXXXXXXXXXXXXXXXXXXXXXXXXXXXXXXXXXXXXXXXXXXXXXXXXXXXXXXXXXXXXXXXXXXXXXXXXXXXXXXXXXXXXXXXXXXXXXXXXXXXXXXXXXXXXXXXXXXXXXXXXXXXXXXXXXXXXXXXXXXXXXXXXXXXXXXXXXXXXXXXXXXXXXXXXXXXXXXXXXXXXXXXXXXXXX
