---------------------------------------------------?--------------------------------------?-o----------------------E--------------?----------------o---------?------------------------------------------
--?-------------------------o---------?-----------E------------?-------------------------------------------------------------------------------------------------------------------------?--------------
-----------------------------------------------------------------------------------E------E-----------------------------------------------------------------------o------------------?------------------
--------?-?--------------------------------------------E-------?------o--------------------o------------------------------------------------------------------o----o----?--------------------?----------
------------?----------------------------------E------------------------?---------------o--------?-----?----------------------------------------?-------------------------?----------------E----o-------
--------------------------?------------------o----------------------------------------?---------------?------?---------------------------?-----------------------------------------?--------------------
----------------------------o-------?--------------------E----------------------------?-E-------------------------------------------------o-----------------------------?-------------------------------
----------------?-----------------?-----------------E-----------------?-----------------E-------------------------------------------E---------------------------?-----------E--------------------------v
----------------------------------E?----o--?----------------------?-------?---------------------------------------?------------------------?---?-------------------?------?--------?--------------E----f
------------------------o----------?---------------?---E---------------E--------------------------o--------------------------------o--------------------------------------------------------------E----f
-------------------?------------------------------?------------------------?------o----------------------------------------------------------------?---------------------------------------------------f
----------------------------?-------------E-?----------------------------------------------E------------E----------?---------------------E-------------------o---------?------------------?------o-----f
--------------------------------?----------------------------------?---------------------------------?-----E---------------o--o--------?--o----------------------------?------o--E---------------------f
-----E-------o-------o--------------------------------o-----------------------------?-----o----?---------------------------------------------o------------------------X--------------------------------f
m------------------------E---?-------------|-----|----------E--------------|o----|-------?--------?-----o-------------X-----------------------------------?-E---?------X----------X|X--|--o---------?--X
XXXXXXXXXXXXXXXXXXXXXXXXXXXXXXXXXXXXXXXXXXXXXXXXXXXXXXXXXXXXXXXXXXXXXXXXXXXXXXXXXXXXXXXXXXXXXXXXXXXXXXXXXXXXXXXXXXXXXXXXXXXXXXXXXXXXXXXXXXXXXXXXXXXXXXXXXXXXXXXXXXXXXXXXXXXXXXXXXXXXXXXXXXXXXXXXXXXXXXXX
