--------------------------------------------------------------------------------------------------------------------------------------------------------------------------------------------------------
--------------------------------------------------------------------------------------------------------------------------------------------------------------------------------------------------------
--------------------------------------------------------------------------------------------------------------------------------------------------------------------------------------------------------
--------------------------------------------------------------------------------------------------------------------------------------------------------------------------------------------------------
--------------------------------------------------------------------------------------------------------------------------------------------------------------------------------------------------------
--------------------------------------------------------------------------------------------------------------------------------------------------------------------------------------------------------
--------------------------------------------------------------------------------------------------------------------------------------------------------------------------------------------------------
-------------------------------------------------------------------------------------------------------------------------------------------------------------------------------------------------------v
---?-o---------??--------E----------E------E------?--EE---E--------o---?-?------------?--------?-??--------?--o-o-----o--?E--o?----o---o--E-o--------?------------E-o?-------?---o--o-----?-------?-----
-----o-------?--?-??o-E-E---E----E----?--?-o-?----?------?-------------??----E--------EE-o-?-?-------E---o?-----?-???--------?-------E-o----?--o--------o------E?-oEE-E------?-------o-?E--------?--?---
---o----E--??---E-E---E-----------------------E---------E---?----o-----?-----o---------E-o------E----?---------?------o----?-----E-E----------E--------------?--------E---E------o-o------o--?---E----E-
------?------E-----o--E----?-o-??-o--o------?--------o-?---?o-------?-?------o----o------?---------?-?--o--?--o------?------E-o------------------o-?EE-----?-?--o---E----?-?----o--E-------o------------
-E----o---E----?----E?E-?-----------------o-----------??-----?-----------------EE----?-o--??-E-----?------o-----?-E---?--?---------------------?--E-------------------o-o-?----?-----??---?oo---?-------
---?------E---?---?------E---E--------------o-E----??----o-------o-E----E-?-----o--------------------oE-------?---o-?--o----?------o---o----E?------E-----------------------?-o-----------E-?---?---?---
m|EoX|--Xo?X|-XEX-X---oE|X-?X--XX-XX|o?-|-E-X-E-||X-||XE---?--X-?---X-X-o-X?-??-oXX|E---E--?|||E-X|XoXX--o--XX-?XX||X------?X----?-|--XX|-ooX----oE?-EXE?-XX--XX--X|E--X?XX-|XXE-|-|?|??X-|oXX??Xo----X-
XXXXXXXXXXXXXXXXXXXXXXXXXXXXXXXXXXXXXXXXXXXXXXXXXXXXXXXXXXXXXXXXXXXXXXXXXXXXXXXXXXXXXXXXXXXXXXXXXXXXXXXXXXXXXXXXXXXXXXXXXXXXXXXXXXXXXXXXXXXXXXXXXXXXXXXXXXXXXXXXXXXXXXXXXXXXXXXXXXXXXXXXXXXXXXXXXXXXXXXX
