--------------------------------------------------------------------------------------------------------------------------------------------------------------------------------------------------------
---------------------o----------------------------------------------E-----o---------------------------------o-------------------------------------------------------------------------------------------
------------?-----------------------o-----------------------------E-------------B--------?--------B------------------?---------------------------------------------------------o--------B---------------
-----------------------------------------------------------------------?----------?--------------E--------------------------------------M-------------------------------------------------------------o-
--o----B--------------M-E---------------M--o--------------B--------------------------------------E-----------------------------------E------------------------------------B------------E------?---------
---------------------M--------------------------B---------------------------------------?-M-----Mo------?-----------------------M---B----------------------?------------------------o-------------------
----------------M-------M--------------------------------------B------------------------M----------------------------------M---------------------------------------E------------------------o---o-----M-
------------------------------?----------------------M------------------M-----------E--------------------------------------X---------------------------------------------?--------------------?--------v
--------------------------------M-----------------B--E-----o-------E-----------------------X?-------------------E----------X-------E-----------------------------------------------------------?-----B--
--o---E??--XXX--?----X??--?---XXX------?X------X?XX---------o-XXX-XE----?----?-------?---?X?-Xo-?---?---??------EE?----?--Xo------XX--XX---E-E---E-XXXX---E-??-?o--X-X--------------?----E--E-XXE-oX?X?-
-M-----E-?-EX---------XX-------X-------oX??-----X--X------?E-o----?X-o------o--E------?-??-X-X--E--o--X------------E----?-XXX--X??-X--EX??E-----E---XXX------------XX---o-o-----------?----?-?-X---XX?o-
--X-o-------X---XEM---X-o-----EXX-E--XEX-----X-oXX?X---------XX----?X------?------o-?--o?--?X--------XE---o-----E------X---XX-X--XX----X---------EE--X-?---?--E----XXXX---E-?-?----------------o----XX--
---XB?EB-?---X-?----?--XX--?-?X-T-----X-?Eo--XXXo-X?E----EM-X-XXX-E??X--X-X-------X--X---XX-X--??-E-X?--?---E-?-?-Xo?E-XX-?XX?XEXX-----X----?----oMoE--B--EEXoo?----X-XX-Eo--X-------o--E----------XXX--
-EXX-o??T-XXX-X----?-XoX-XX----X|-XXX--XXE?--X-X?--XET?X----XXXXX?--XXT--X?-T----?XEX---?TXX-?-?X?MXX--E-?-------o-X--XXo?-X?XE?X---?--XX----T??---X---X-----X-?-X?o-X--X--E-XE-?---B-X-?----T---XE?XB--
m-X?---o|-EXXBXXX-X-X-X-|XX||XX-|--X|--X--|---X-|-??X|X-X--?-X-XX-?-X?|-XX?-|----E?X?--?-|X-----X--X----o----oE--oB---XXXX?MX-?M-X-E?|XXEE-o-||--|X-?--X-?o--?X-E?X-oXE-X-?--X?-?EoE-X--?-X--|EXXXEX|X?-
XXXXXXXXXXXXXXXXXXXXXXXXXXXXXXXXXXXXXXXXXXXXXXXXXXXXXXXXXXXXXXXXXXXXXXXXXXXXXXXXXXXXXXXXXXXXXXXXXXXXXXXXXXXXXXXXXXXXXXXXXXXXXXXXXXXXXXXXXXXXXXXXXXXXXXXXXXXXXXXXXXXXXXXXXXXXXXXXXXXXXXXXXXXXXXXXXXXXXXXX
