--------------------------------------------------------------------------------------------------------------------------------------------------------------------------------------------------------
----------o------M?--------------------------E----M------------o----------o?----------?-B--------------B-------M-oMB-M------M-E?-------------?-?----------o-MM----------o---E--B-M?BM-------------------
----B-----------------o--?--o-M-B--?-M--------------M--E---------------M---EB-------?------------o------------------B------o-------E-?---------?-?--o-?--------------------oo--------------E------------
------o-?-------?---E-----------M----o--M------M---------------B----o--------B----o-o-Eo-M----B-E--E-------E-B--E--M-B---?---?o--E-----E?o----o-----o--M-----o--------------------------B-o--B----------
----E------------E?B-BE-----------B-------B----E-B-oM---M------B-----?B--o-MB---E??-----BM--------------E-?-M--------M---E?------B--BM-?---M--?-o-------?---o-------?--E----B?-----B--------M-----------
-----BE------?---------E-o----B----M----?------------???---------B-----E-?---o-------------E-----Eo-B---B--?-----o---------?----B-?---BE-oM---------?-----B-?-?-M-----M-----------E-o?--oE--------------
---------M?-M-------------B-M----E-oMo--------M--B-?---E--------------?---M----E-E-----E--BM-?-M----M-M?----------------------EE-------?---E-----------o--o---------E-------------------M---------------
-------o----------o---------o----E------B--------------E-M----B-------------M---oE--Mo----B------o---B-----M-B-------?M------E--B---M----M----M----------------BE----E?-----o-Mo-----E----B------------v
-?-?-M-?--E----?-----MoE--E-o------------------M---E------------------?--------o-E---B-----B-M-------------oEMo------BE--E--------oE--E-------------M----Bo--M----------E--B----o----B-----oEB---------f
---B------M--M-----E--------BM-----M---o--E-----EM?-?-------?-?--M-----?--B--------M--Eo-M--------M-B--------------o------------------?-oB-EME-E?--MM-?M-----oE-B------E-B-B----E--------M---X---------f
---?--o--M--E--B-------------M-Mo---------------o-----------o---o?-?---------E-M-----EEE-M-E----------E-oB-----?----------E-B-----T-Eo-o----EE-o----E--oM----------ooB-------M--M?M----M-----?---------f
-E-E-E-?-o------o--B--?------M--|---------o-E--------B--o?o--X--X---o---?M?-----E--o-B-?o----o-----?o----MMET?--?-o|---X?MM-------To-oM----?-------|---XoooM??-EoE--XBEo--B----??------------X---------f
----------?---------o-TEB-ETE---|-|-EBE|-----|--|----------|-XXX-X|-TMB-----M-oE-|--T-------TBM-?M------T---|----B-|?oo---To--B---|-|--------o-X-E-|-|--?E---XX---M?XX---EMX------o---?EB----X---------f
--------|-TX----TTT--T|----|--|-|-|--XT|-|--E|-o|--?oMT----|-XX-X-|-|--B-ToBT?--TTE-|---|-TB|T?|--EX|--M|---|-T--|-|-ET-X-|-|-T?T-|-|-TE-|--|-TB--X|-|--?-X-XX-|--E-XX--TT|----|-?E-|-X---T-XX---------f
m--|--B-|-|-|---|||-E-|--XE||-|-|-|--XX|-|-|-|--?|-X-?|---B|-EX-|-|-|MXE||-|||-|-||-|--B|-|-||-|-XX-|--E||--|-|-B|-||-|-|E|-|-|-|?|-|M|--|--|-|---X|-|-X-|-XMXB|-o|-X|--|||-B|-|-|-X|-X|--|--X---------X
XXXXXXXXXXXXXXXXXXXXXXXXXXXXXXXXXXXXXXXXXXXXXXXXXXXXXXXXXXXXXXXXXXXXXXXXXXXXXXXXXXXXXXXXXXXXXXXXXXXXXXXXXXXXXXXXXXXXXXXXXXXXXXXXXXXXXXXXXXXXXXXXXXXXXXXXXXXXXXXXXXXXXXXXXXXXXXXXXXXXXXXXXXXXXXXXXXXXXXXX
