?BB-M--B-?o-o--?-X--X--|--|-o--?--?-|----X--X?--XoBM---MBoE-oM|-M-E-X-??-?-E----XMT-EX-BX?TB?--XXTM--M--B--B|T-Bo-Eo|M|--MEE----o|B?oB|XMo-oX-MMM-TE-|M|o-|--M----M-T----?-X-?B-To-EBBM?|EBTo----X--|BoT
|MXE-T--TB|E----MoM------T|--o||-?---?MBMTM?-B-----E-?-EBT-BM-XTB--B|-T--M-?-M-T-T-TEMoE-----EB-EXX-|--M|----?E--EM|M||T--BE-|M---o--|---o-|E-----EXMEXo|-o--ME-E-MT-BooEo-o?--o|------?--TB--?--T--M-|o
oE-|T--o?MX--|-?-B-T----X-?MM-T--E---?|-|---B--X|---EX--o-E--|---|--XM-|--|XB-ME?|T---?-E--T-||Mo--M-Xo?-E----|-XE?M--|------XT--E-?B--|MBoM-E--?-X|?TB-X---?T-T--B-E--?-MM---B-|o-Bo?T-|?--?-BEM---?MBM
ooMMoE-B|-|?o-----XB-T-X-X-??-BB--E---X---o?-?X|B--E-T-M-|E-B?T---B-o|T-T-MX-X-M-|?-XE||-B|B--EX?o|TE-?---Mo--o?-B-EB-|---T-o-M--B||--TMTE-MBTBEE--?--?X?XM|-B-TX-o?MEMo-X|??TT---X?-E|M-T|E-M---oX-TT|M
TBE-X-?|---XT---BXMo-XMX--MB---E--?---X-E------XT-BE-Xo?-B---?ETM-E----oo|BBB?oM--oXo--?-X---XMM-|--o-o----MXM-|-|B--?--||-o---X|---X|?|o?EEM|----B|oM----|XM??B--B?T-?--Xo-MT-X?X-BoX-|-B|o-XM-X--XTM--
?T-M----X-MM--oEE--EB|B--MoE--T-X|--M-o-|o-------E-XT-T-?XE?--XoT|E-MM-To-MM?-E-MX--MoE--Moo?---M-??o---E--X-MEE-M-o-o-M-EX?oM|---E-?-----E|--MoTM-ET-|---?E-?--TTTM--XME|----?T-----BTBX?-Bo---X-|TT--?
MTEM--|B-M-B-|-E||B|?----E|-?-E--E--o--?--T|--|X-M-|?oM?----TM-To-B?E-E?-?o-B----?Xo----MTBB-XT-o-------|-T?E--X----B-B--|---|--E---|XTXM|B-TTEo--B-?oM?-BB---To|-XTo?Boo---XT-----?oo|T-?--EM-EB-oM---T
X--?----ET?TE-|-o--T|---XME-M-B--?|--E-o---XB-X-T|--TMB--BXE-ME-MT--M--Bo-X--|BMM?Eo---?-|-|T-B-TB|--XBB-|--EE|-XXBBMB--X-M-?|MBXEE--MX---?--M-EE-XM|-M-o||-|TXX--?o----X----E-M--o|o-M-T|X--oM-XB-|-M-v
?-TB-X--?--E-E--XX-o--MX-?-----T|?-X-?--|T-M-XE?X----E-oX--?XM?o----ETEEXB-|--B---?Eo|-|-BX--XBEoT-|---B-B-MX--o--o|X?BTT--?|----B-------|--oM-EB----?---B||T--B--?-|oE-B-----X--?--??E-|B?---EX?-?-EB-?
BoXT-?-?M--EXE-?----X--ooTM----B-?--oT----XMoEX--X?|TB-MT--MT-XB---M|TTT---M-?-E-|BXEE---X|oo--o----XB-TBM-oX-B----|-?BBX--XT-X|---X--?X-X-MM--Xo?XX--EoX--o-B?o|-T-?-M|-M?M----oEo-----|M-o---oBE---?E?
-|-?B--X-o-oB|?E-----oBo-oB-o-TT-XToXX-T?BBM--X-T--MoBM|-E|---B--|o?--o-B?X?|TX-MoT?-E---oT-X?X-oX?X|o--M-----XTXE-XM-MoX-|-B?---To-Xo-o-|Eo?-----|-EB-----Bo-|B-TBMXBME-|--BEB-MX--X-B-E--|--X?-M?-MTMX
o----E-T---o-T?M?EX-o-|X-?---EoM?X?-?--?--|-TTTX-|B-?E---?-----X--X----TM--?To-B-?-E----B-?-|-----MT-o----XB-----o-oB-|M-BX------E|--|B|-E--XE|-oB-BBMB-M-BEB--?MM-----?B?X-X--?T-X||MXM-|--BB----MTo-TM
M-o---T?|--?T-|X-XBTE??-MoEB--TB|EB-X--o|BE-MX|----E---|E---T-Xo-|?--o|?B--M-o?B|-X----oTMM-M-----E---X----o-TXMM?|---|--o-X-XTX?----E-oX|--B----?--X?-B-BM-oo--BoBBX-------?-E|----MXX--?-XM|--|--|B--T
-X-?X--T-?---Xoo?oT-M--|--E--?--M-EB?ToMB|B-TMB-?-Xo-MTT--o-------B?o-X?M-TT|BMEX?-X----o-BM?MT--|-T?M-BXM?----|-?-BX|-B|-------M---MXMXETEB--M-Xo?B--X-|X-T|o--o|TE|-XM-Xo---o?-B--To|-E--MT-B-?-XTooE-
mX-?E--M-Mo-TT|----EBE-T-X-|BTE-EE-E-|T----XXX---BEM--Eo-----|---X?MX--oET--TBXo--|--|-EoB-|oT|--oBTTB-|||M--|--MT--oE?o|MM--M-BB?--T---X-BXoB?-EoM----?oB-BE|-|MM---TM-|--M-M|-----E|T-|TXo--T-M---X-oE
XXXXXXXXXXXXXXXXXXXXXXXXXXXXXXXXXXXXXXXXXXXXXXXXXXXXXXXXXXXXXXXXXXXXXXXXXXXXXXXXXXXXXXXXXXXXXXXXXXXXXXXXXXXXXXXXXXXXXXXXXXXXXXXXXXXXXXXXXXXXXXXXXXXXXXXXXXXXXXXXXXXXXXXXXXXXXXXXXXXXXXXXXXXXXXXXXXXXXXXX
