-------E--------------------------------------------------------------------------------------------------------------o---------------------------------------?-----------------------------------------
--------------------------------------------o--------------------------?---------??-----------?-----o------------------------------------------?-?------------------------------E-------o---------------
---------------------------------------------------------------o---E-------o-------------------------------------E-----?---------------------------------------------------------------?--------E-------
-----------------------------------------------------------------o----------------------------------------------------------------------------------------------------------?---------------------------
-------------------E---------------------------------------------------------------------?-----E------------------------------------------------------------------?-------------------------------------
-----------------------?E---------------------------?-------------------?-------------------o-----------------------------------------------------------------------E-?---------E-----------------------
---------------------------?---?--------------------------------------------------------------------------------------------------------------------------------------?---------------------------------
----------?-----------o---------------?----------------------------------------------------------------------------o--------------------------------------------------------------------------------E--v
---------?--------------------o-----------------------?------?--------------------------?---?---?------o----o----------------E----------------------------------------------------?--------------------f
---------------o---------------------------------E--------?------------?----------E---------------o-----------------------------------------------------------------------------------?-----------E----f
----?----------------------------------?------------------------------------------------------------o-------------------------?------?-------------------------------------------------?---------------f
-------------------------------------------E?------------------------------------------------------------------------------------E-----------------?------------------------------?-------------o------f
-E-----------o--------------------------------o------------?-------------------------------------------------------o------?----------E--------------o----------?-------?----------E--------------------f
----------------------------?---------?---------------------------------------------E-----------------------------------------------------------E-o----------------------------------------------------f
m---------|------------------------------------|---|---?-----|--------------o-----------------|--------------?|---------|-------|---|----------|-|--o-----|----------------------------|---------------X
XXXXXXXXXXXXXXXXXXXXXXXXXXXXXXXXXXXXXXXXXXXXXXXXXXXXXXXXXXXXXXXXXXXXXXXXXXXXXXXXXXXXXXXXXXXXXXXXXXXXXXXXXXXXXXXXXXXXXXXXXXXXXXXXXXXXXXXXXXXXXXXXXXXXXXXXXXXXXXXXXXXXXXXXXXXXXXXXXXXXXXXXXXXXXXXXXXXXXXXX
