---MM--T-o-o--T-MM-XM-E-M------TXBX--o-??--To--M--?-?---|EM?-?-?--XTX--?---X?E----TM----B-T-E-o------BTE--?o-EEE-E-----E----MM-BM--T-E-BE-o-oMT?E----M---o-T-Xo|-oT-M-To-X--B--TMXM--M-M-oM-T-|??---B---
--Mo-|---oM--E-------X?--TM----TBM--|E---?--M-?T-TXEoX--T-|-X|-M-----EM??-?--T-M----oB-EET-??----E?--T-o--------?-E--T----MT|M----TE--T---X--?-?o?X--?|??-oTBM-M---MB------o-?----T-?-MoXM-oo?--TX--B---
--T--MMX---X-?--X--E|T-M--o-|o--X-XM---------B-E-X-|Xo-M-EM-o---B-MEB------T---|XB-o--B-M|B-TE--X--?---o-?-MEM---|-E-Eo-oM-?------M-E---BXX--M?----oo-|-------ETMo-M---oMX-----X-?-M-M-EB?T----T?----?T-
--o-XX---|-----M---M-?----XMB---|Eo-----|-?--X?--X-oB-|-B-M--X-o------?-o|-oE--|o----?-------MB-MBE-M--E----E---|-X-E-B-??---M---X--E-M-oM--TX|T--?-BT---Eo---|-B-B-E?o----TETM------X-X----o---o?-M?MB-
---M---|-?MT-B--E?MXTMB-E---??M---BXo-Bo-|-|E--oXE-?--XT-?oM??T-?X-|--TX----M-E----o?-M--T?X--T--o-XM-TE-X-BM?-----o?o-E?-TT-M-T-B--M-----------o--o--TToB-E-MT-EE?-|-?--M-T---E-|--?M?EE------?B-XE--M-
-M---|-?-X----X--M-?-M|--M-----E-BoEXBMX--X-o-M----TB|o--X|--BBEBX?T-X?|--E-----o--|----B|-??M-----oTT------B?---E-XB-?----EEE-M-M-----X-?Mo-o---o--T|-Xo---E--ME-B---BT-E|?-XT-B----M---TB---|-o----ET-
---o----oB--X-MX-----?--T----oB---X---M--E-T-T-E-?X-----BM---X-?-o---o--MEE--oEMT-?M-|X-|X----o---B--MT---B-M?---XT--M---M------||M|---MB----oTXBMM---?--M-----T-X----?|--o-o|-E?BT-E-B-E|------E--T--|-
--T--X---E--o--?--XB-|E--MX-EBT--M-?----BB|-XM--E---BEXM-MB-----XE-?--T----o?T--|M----XB---o-------T--ET-o-EM-oX-o-|--T-----E-BTE-?--BT---o--T?-o----M-BT--M-X--?E-|----M--------?-----?X-T-----M-B----v
-M-----X|o------B-?-|X-T-B--M-B-E?B-X----M-X-?-Eo----B---Bo--||-X--TBXM-----M|-----TX??|-E---|o-M-MX---?-??--X-BB--B------------B-M---TE--M-To----TM--T-oE-o---T-|X?|-|E-XX|---XX-----?-o-o--|E|--T|-?Ef
-----oBM-X-M-MXM-X--BT-M-TXo-E---XM?---------|XM--|-o--TMo---oM----------T--B-BM-EM-|o----TTB-M--XEX-|---o?--B-XM-?---?---B-oXT-o--|--o?MB?---------|-----------MBM----?oXXoo-?X-M|--B|T---M-X--Mo?To--f
-?E|-?-BE-o-----MB-M-oB-E-X----M-----T|-|X----oo|BX----M?-----o-T---T--------E-o---BBoBE----MT-T--BMEME--------T---T-M-X|----X--------o-----X---BM--EM-MT---E-oEE-?-EX-----E--o-o------o----EE-------?-f
---B--T-T-BM---M|B-B-----Eo?B--?--?X---oB-XB--E--o-?-oM-|--EM--X--EMM------|E---BT-o-B--B|-o-------?M-T--?-E-MoE---?||--M----|-BM-oX-?--------|---M--|X--o---T-?-M-E--B-?E-|TB-T?|X--|-MMEE-M-?---M-TEMf
-E-B----TE---T---B--oTE--o-o-----MX?B-B-B|------?----E--E--ETBT|---X----M--?-M------|B-X--o-E-B--MM--o---T-----?E----||-o?ME-------------E---E---XoX--M---MET----o-----E-M-?X--X-ME-T------o------T-T-Tf
-----X-T-B-X--M-|--Eo?--?---X?---XT-------B---|-?B-ET|-?|o-------o---E----T---T-X-|-B--o-?-EB?B---MX-?B?Eo---M---MME-oo-X-X-T----M-XX---B-?-XMoMX-X-E-BB----M?-?----T-E--M--EEB-T|T-M--E?EBoX?-o-E---M-f
m?|o-|----T--?o-M-T?--|-X-T--o--o-?T?-o-E-X---T-?|--E-----|--EX--X-T-?-B|-MM-M-|TM?---MXXo|-X-----B--M-TB?-B--o----M---X--X-MM|--T---?----E-B??--X-?XE---ET-?-----TMT--BT---ETXX-E-o--?-----MX---||T-?-X
XXXXXXXXXXXXXXXXXXXXXXXXXXXXXXXXXXXXXXXXXXXXXXXXXXXXXXXXXXXXXXXXXXXXXXXXXXXXXXXXXXXXXXXXXXXXXXXXXXXXXXXXXXXXXXXXXXXXXXXXXXXXXXXXXXXXXXXXXXXXXXXXXXXXXXXXXXXXXXXXXXXXXXXXXXXXXXXXXXXXXXXXXXXXXXXXXXXXXXXX
