-XE|MXBBM--BE---o-??-|--MX--T-?--TM|BT-oo--T?M?Mo-M-M-?-B-X?-----X-?-|Xo--?-Bo-----E--T-M-X--Xo-TXM--?MTBo-B--T??--TE-E--M|o|M---B-XTMEMXBTX-T-M|?-XE--ToTX?MTB-Eo??E-?----X-XB-XBT-?E--E-o-E|MX--------
-MM|E-MoT-M--EXoB-XE-B---|-E-MM-??-|---MT--MT-oT-B--X-------MT||----??T-E---M-M--X-B?M?TBE--TE-B-M--|-B--|MBo--|XBo-E---?---o?--XoXoEET?-XM-??-BBoo-----B----oE-B?-o-B|--?-E-E------o-TX-?EXoo-EM----M--
---oTo?-o--?M|MXo--EMX--|---o-T|--?E-MEEMXo|----|-X|E-?|EM-o--ET-EEX|M-?-E--ET|---X|-XB-T-E?---XMo-Xo-o--XXT??---|ToEB--?B|MT|---XT?---X-MB|E|-o-E-E|-T-oT-X-X-B---TTMXX-T----o-X-B---|-X|-oT-E|---B--o-
-|?T-M--ETEBBM--o------?--E|T--|E-E---o-X---M|--M----E--E-----M-oX------T---TXM--B-T-oM?--?--|-M||---o--oB?ME--T-M-|E-|---B?T--TME-XB||?Eo-T-X------Bo-E|MM-|-?|--?--T---X|-?MEEo-o-o|EEM--Moo--|-XB--|-
-MTEE--B|?o?--MM-|M-MM?-BT?oMTo--|TB?XE-o---|E-|-B--?X|-B-o--T--ToXT---------TMEo---M?-T-|o-?--?--|-BB--|--X--E|BB?B--o-|?X-XT-?-BTBMX-|-?BEXM-M-EMM----E--o?Bo-?X---XT?X----Mo--Eo------o---E?B-oMo-BX-
--ToM-o---?-|--BX---XoBoM-BXE-X-X--??T---BTME-?M--B---|--?T--oTT--XE---T-oM-?BMM-TT-|T--|--B-T?-o?-B?-|-B|-M--?--?---||-o---o--|XM?-?-To-|XMM|?----|BXB-BTo-oX|E------o--X---ME--EoMMXXEoo-TMX-||-TM-oT-
-B-Eo?-|---|-T-T--oB---EEo-TBo-E||X-T-|E|-??E|-MoEBXoXX-M?-o---XE-M--|ME?M---oTEXT----T-E-X?---B--------X-oE|-oM----B-E-M-oT-oMo--T--?-?-??B||?M?-o--X---oXB-E--E-E--T---|-T-----oMMEXMEM?--|-Xo---EB??-
-X---EM-T-TXE--B-?EoMB--?X-BBoT|X-M-X??M--?M--|??XBXM---E|?EoXEMo-?E--X--?X-o-MEE-M--|-T?-|B?|----X--|--X?BX--T-?B|Bo-TX--?-X-?|EBo---?--??-TBo----EE-X|oMTMB?M-||----?T-EB--||-X--B-|-Boo-T|?E---X-B-Bv
-TT-E--oB-XE?-T-?B----B---E---|-X?o-o?|o|-M--T-o--MEMMEX--MoX--o|--T--M-XXX-o-oMT?M-o-E----E---B-TE-Bo--BT-|-M|MEoMM---oBo-EE--oTXB--MoXMX-E-TXEBE-TT|XX------XEX--EE-?XB-----?|-TTB-M-oo|-BE--?--M-X-Tf
---o-M--TB----|XBBXT--EB-T-T-MB-----TB?Xo-Bo-E-?-T---|-|-X-------?BTT--BXEX-----o-?EM|---?--EM--B--M-X--M?T-M----|oX--|----ET-B-T-T|--X-oM--o-B----?--|-MB-|-EEEo-?T---M-B-M?-MM?|--E---oM-XMo-XT|EX--Tf
-B-EXE--T-XX-E?-----BMo?--M-B--|?X-|-E-X--E-|?-X-Eo-?-EBXo-T-B--Eo--B-T-?oEM-EE-T---BB-B---E-TE-?T?-XoT--M---?-X-----|?|o---M??--B-|-o---MT|--|B--BX----B-B?---T-oTMT-o-?B-----TB?B|o?--T??--Too|--XBE?f
--XX-B------X---?B-|B-To--E--MToT-X-B---|---X---?o?-X|-T---o-EM-----B----TXX--?TTBo|BE-T--B|--|EE-o?T--X-M-?M--?TB?-B??EB-B|oE--EE---M-|--B--?--|B-ETX|-M--|B--BX-B??--M-B|-oE--MTB-BB|ETT--TE-E-o----|f
--BE?-o|B----|-M-Eo-|--BoX-B?-TE---T-E-|---|TB-?TX--B--?-----XB-X--E|-?B----X----|||-EMMBE|o---|X--MX||-B-BB?-?-----M-?-XBEBM-X?X-|BB--------E--EB-oB-?MBM-T--MM?E--BEB-EM-T-oE|?|--M-|-T-T?---oE|BBoE-f
-o-o----MoMXMM-E----oMMTXX----B-MXB-o-?-X-|-XM-o---E-B-o---B--TTMMM--??TE-||?-o|-|Boo|-B-?--?|---XT?--o-E?---MoBX?-|--EX--|-?--o-XXoo-XM-MM--EE-T-XTo--o-----?-TX-|?X?ETE----|T?-E-oX-|-X-Eo--EXB-M-ETof
m-T?XM--T--E-M-B--B|----XX?T?-oE-BTE-B-T--XE--|T----E----oME-X--oM---T---oB-?--?|-TT-ETEo?------?----TMTM---BBM?---MBo||TX---M-EM--E---|?XB--XX---oM--BMB-B-----BBM|B|?-o-?BB|-?o|oo-E--|?TMX----E---?|X
XXXXXXXXXXXXXXXXXXXXXXXXXXXXXXXXXXXXXXXXXXXXXXXXXXXXXXXXXXXXXXXXXXXXXXXXXXXXXXXXXXXXXXXXXXXXXXXXXXXXXXXXXXXXXXXXXXXXXXXXXXXXXXXXXXXXXXXXXXXXXXXXXXXXXXXXXXXXXXXXXXXXXXXXXXXXXXXXXXXXXXXXXXXXXXXXXXXXXXXX
