---------------------------------------------------------------------------------?-------?-----------------------?------E-----------------------------?---------------------?------------------------o--
----------------------------o---------------?---------------o----------------E------------o----------------------------------------?---------------------------------------------------------?----------
-----------------------------------------------------------------------------------o?--------------------------?--?-------o----------?--------------?---------------------------------------------------
--------------------------------Eo---------E--?------------------------------------------------------?-------?-?-------------------------------------------?------------E?----------------------o-------
------------------------------------------------------------------------------------------E?---------------------------------E-----------------------------------------------------E--------------------
-------------------------------E-----?----------------------------------------------------E--------o------------------------------------------------E--------?---------?--------------------------------
----?E------------------------------------------------?------------------------?----------?------------------------?------o------?--------------------------?--------------------?----------------------
------------------------------------------------E----?---------------------------------------------------------------------------o------------------o-------------------------------------------------ov
---------?-----------------------------------------------E-------------E----?E------------------------------------?------------------------------------------------------------------------E-----------f
----------------------E-------------------------?---?-----------------------------Eo---?----------------o------?------?------??-------------------------------------------------------------?----------f
----------------o-------------------------------------------------?-----------------?---o?-------------------------?--------------------------------------?---------------?------------------o---------f
----------------------------------------------------?---?---------------------------------------------------E----E---------------------------------------------o----------------------------E--------E-f
---------------------?---------------o------------------------------------------?----------------------------------------------------E-------------------------------?---------------------------------f
-----------------------------------------------------------------------o-----------------------------------------------------?-------------------------------------------------------o----------------?f
m-|-------------|o---------------|E|-------|---------------------?--------|--|-------|----------------------------E-----------|-------E---|-----?------E-|-----o-|-----------------------||----o--o----X
XXXXXXXXXXXXXXXXXXXXXXXXXXXXXXXXXXXXXXXXXXXXXXXXXXXXXXXXXXXXXXXXXXXXXXXXXXXXXXXXXXXXXXXXXXXXXXXXXXXXXXXXXXXXXXXXXXXXXXXXXXXXXXXXXXXXXXXXXXXXXXXXXXXXXXXXXXXXXXXXXXXXXXXXXXXXXXXXXXXXXXXXXXXXXXXXXXXXXXXX
