--------------------------------------------------------------------------------------------------------------------------------------------------------------------------------------------------------
---------------------o---------B--------o?--------------E------------------E----------B----?----------?------o-----B---?-----------------------M---B--?----------o-------------B------------------------
----o-------------------------M------------------------E--------------B-------------------------------E-----------------B--------M------------------M-----------o---------oE----------------------------
------------M-------B------------B-----------------------?-----------------------E--------------------------M-------?-E---E--o---EE--------------------------E------------------------------------------
----------B-----B------?-----------------------E-M--------B-----------------------------------B--------o----------------------------------------E-B-------------E---------------B--------B--------------
---?-------------?------?o----------------------M?o----------------o-------------------------------o----M-B------------------M--------------?--M?B----------------------B----B-----?-----E--?-----------
-----------B--o--------B-o-?-----------------------------?----------------o-----B------------------------M--M---------------B--------------------B--o-----B?----?-----o-----------------E---------------
----------------------M-------------?E-------B---M----------------------------B---?-------M----------------------------------------------M--------------E------------M-M?-------------------o----------v
------M-------?---------E------------------------------?--Mo-----oM-o--------------------o---------E------------?--------------?------------?---------------o------------------------B-----------------f
-o--E---E-----------oB-EMEB----M--------MBM--------o-------?--EM-M---o----?o-BB--o---?E--------?------B------M-?-o-M-?--?M--MME-M----E--o-o------M-M-----?M---oB-B----?---?E------E-?--MBEEB-----------f
------EM---M---B--B----o------M-----?---o--Eo---------?----------?-------?---M--------E-o-?B----B----o--B-E--M?--------B---?-oME------?----------M-M----o-E-o--------EE---?---o--B---------Boo---------f
---M--?--------o--M-------M----------M--o---?--?o---X?-E------------M--TB-E-o---M--E---X-X---E-----E--?---E--E---B-?-----EB----------E----X---M-M-M----??-oo-----E-XEMM-X--T-------B--B?M-T--E---------f
--E?T-TTB-T-M----o-----M--ME---?---o------o---o-E---X-ME----E-----B-B--|----------ME--MX-X--o-----E---?-E-E-X-X---E--B--E?---EX----oT---o-X---------B---E-------M-XX----X-E|oE-----B----B-|------------f
--?T|-||-B|M--B?-----M---|--TTT-?---M---?TTBT--T?o-?X-ET---TBT--Xo|---X|------E-XTT--X?-X--TTT-----X---?--oXXXT-----XXXXB-XT-o-XXM-o|-|---MB|--o-T--?T--oE-TTM-T--X-M--TEMX|--ToB-MTTT-ET-|-MM---------f
mBX||-||--X-X|--X--------|---E|---|------B|B---|-X-oX-X-XB-|-|B-XX|-X--|-EB----XX|-B---|-B-||||--X|-X-B-----X-|-||?BXXX-X-X|-BXX--XX--|-----|BX--|--------B||------XX--|-XX|--|---X|||-X--|-|----------X
XXXXXXXXXXXXXXXXXXXXXXXXXXXXXXXXXXXXXXXXXXXXXXXXXXXXXXXXXXXXXXXXXXXXXXXXXXXXXXXXXXXXXXXXXXXXXXXXXXXXXXXXXXXXXXXXXXXXXXXXXXXXXXXXXXXXXXXXXXXXXXXXXXXXXXXXXXXXXXXXXXXXXXXXXXXXXXXXXXXXXXXXXXXXXXXXXXXXXXXX
