--------------------------------------------------------------------------------------------------------------------------------------------------------------------------------------------------------
--------------------------------------------------------------------------------------------------------------------------------------------------------------------------------------------------------
--------------------------------------------------------------------------------------------------------------------------------------------------------------------------------------------------------
--------------------------------------------------------------------------------------------------------------------------------------------------------------------------------------------------------
--------------------------------------------------------------------------------------------------------------------------------------------------------------------------------------------------------
--------------------------------------------------------------------------------------------------------------------------------------------------------------------------------------------------------
--------------------------------------------------------------------------------------------------------------------------------------------------------------------------------------------------------
-------------------------------------------------------------------------------------------------------------------------------------------------------------------------------------------------------v
--------------------------------------------------------------------------------------------------------------------------------------------------------------------------------------------------------
---B--o-o----E-E-Eo------BEM-M-oB-B---?--B-B----------B-o---?E-?------o-?B-EM---B-M------o------?---E---o--?--------------EMM-BMM------Mo-----E---E-----?---|----B------o?-----B----BE------o-E-BM---E--
------TE---o---o-----M------E----------TE------B--M-?-?Eoo--o---o------oB--?-oo-----------T-M--B--MT---------------------?o----M-----M---o--T---o----T---EEX|o--E-E---o-------------B----------?-B---E--
-BB---|?---M-----------EEB-E----------B|----B----o--?------E---TET----M---o---XEo--Mo-?-B-|oEE?--E-|oB-------M-??--T-----BB--o----B---------|o---?--B|--XEXE|-o-----o---oMT---MBo-o--------E------M-----
--B?M-|M------B-MT--------TMTTB----?E-X|-EE--------T--M-T------|-|-?--E-T-oXM-XE-?----TT--|----B---|--M----T---M---|------MBT----------E----|------XE|?-TX--|----T--T-T?--|---TT-B?---T--?-T-B----o-E---
--E---|----??-?--|MTT-oT--|-||-ToT----X|-TTEoTTo--T|TTM-|-T-MT-|?|-B-ET-|E--X-XT--ET--||TB|-TT-TTBT|---T---|T--TT-E|--B-T---|-?-M---T-TTE-T-|-------X|T-|MX-|T-?-|-M|-|-TM|-o-||--T--o|oT-T|BET--T-o-M--
m---XX|----------|-||--|--|-||-|-|----X|-||--||---||||--|-|--|-|-|---X|-|---X-X|--X|--|||-|-||-||-||---|---||--||--|----|---|-------|-||--|-|----X--X||-|-X-||---|--|-|-|-|---||-X|---|-|-||--|--|------
XXXXXXXXXXXXXXXXXXXXXXXXXXXXXXXXXXXXXXXXXXXXXXXXXXXXXXXXXXXXXXXXXXXXXXXXXXXXXXXXXXXXXXXXXXXXXXXXXXXXXXXXXXXXXXXXXXXXXXXXXXXXXXXXXXXXXXXXXXXXXXXXXXXXXXXXXXXXXXXXXXXXXXXXXXXXXXXXXXXXXXXXXXXXXXXXXXXXXXXX
