---E-----E-------o----?----oE-o----M------------o-------M--E-E-------E-----------E?-o--B-B---M---M-------B-------o?----?---M--E--?-----E-------E-----o--M-----B-----E---o--------------E----------?-----
-M-------M--M-----B----o--o----B?-?-E---E-----o-----E---------E-o-------BEM------E-?-B---------?-----M-------o-----o-----------------?-o---M-------?-?----?oB---E------?-B----o-------------------------
---------------M-----------o-----o--------B-E---------?-o-----o-----oo---Bo------------E--o--B-----oM-----------B---------E--o-MM-----o-M----------o--o-----?--B--E---E------o---o-E--o-----------------
-----BB------E-----?------------------o--E-E--E--B-----M--------o--B-------------EB-------------E-----MB-E-B--------E----M---E-M----o-----o??------------?-----M--?-----o--o---M---------------BM-B--Mo-
-Eo-----E------E--?----------M-------------------B--M?-----?-----Bo-----B--E----B--E-?---E-EE--------?M-?----M---------B---o-MM-------o----B--?M-----------?----o-?-----------B----------E-B-?Bo?-------
-M--?--M-B-o-----?----?B-------M--B-------BE-------M-?----o--------E?-o------B--M----o?---------M---------M----o--------?------o-o------B----------o-?B-----ooE-------?E---E--E---?--------------M------
--E--?----B-o-?----o-------------MM-B----------?--?--Bo??-----o-B--E--B--M---------o--B---B-------------E?-MB--------------B-M------BB-------M------------------B-----oM----M------------o-oBM----B-?---
-E---------------------------MM-----------o-----B--o--------Bo-----E-B--E-----M-M---M-------?------E-M-----o----M---o?--B--M----M--B---o--------------------?----------------?---E---E--B----B----E----v
-----------?----E--------o--E---o--E--M-------?---o------------B---M--E------------------o------B------o----------------o----E------?--M--B-----M--------o--??----M-o-E---?----M-------?-?Mo----ME-----f
-o-----o-B-----M---Eo----EEE-----M---------------?--M------?o--M----B----?---E--------------B------M-M--M-?-B-o--------M--E-----?---M-------M--------M-----B----M---M------BM-E-o--M--B----------------f
---?--B------------o------oMMo--B--?-?E----------M---oB---E--?---M-------?--M---------B---?-------oo----------------------------------B-----------??--E--??-------------------?--B---------------------f
-----B-------B--o--?E--M---?-------------------------------M-B---B---o---------?-----?E-E--M-----M-----?o-------E--------------------------BE--?--B-------E--E---oB-Eo--------EB--o-E----?---------M--Bf
----------BE-------?--B---E------?--------B-------o-------B-------oEM---B--E-M------MM-----Eo---------o----o-----E---?---------------------M----o---?---o---o---E--MB----??----M--?-o---E-----B-BB-E---f
-M-----?-------o-M------E-?----BB----E----------E--X------------B----------E---------------------?E------E--o----oM-B--------------E--?-E-------------M-------B--o-B-o?-----BM---B--E----??-M--B-----M-f
m-----B-----|-XX-----M--------------------o----M--X---?o-----------o----------E-----M|--E------X-M-|---o-----EE-------------o----------E-BX------------X-------M---?-|------o-M----o--?-------?--------X
XXXXXXXXXXXXXXXXXXXXXXXXXXXXXXXXXXXXXXXXXXXXXXXXXXXXXXXXXXXXXXXXXXXXXXXXXXXXXXXXXXXXXXXXXXXXXXXXXXXXXXXXXXXXXXXXXXXXXXXXXXXXXXXXXXXXXXXXXXXXXXXXXXXXXXXXXXXXXXXXXXXXXXXXXXXXXXXXXXXXXXXXXXXXXXXXXXXXXXXX
