------?--XE------?-E------------o--?-------------------?--M--o-------X------------M--------------o----M---B--M---BB--X-----------------------?-X-------------o--B----------o----------E-X-MM-B-----E----
---M--------E--E----X----M---Bo-------------?o--E--------EB-----------o?M-----E--B-----o---EBM------------?-------?-------o-------------------------------E---------------------------------X--X--------
-B-Xo--------o?----E-------------B-----------------------------B---------B-M------B-----------------X----------B-------E-?----E---------o--------E-------B----------o-MX--oM-----?------B------B-o-M----
-BX-o--E------------------------------E-----E----?----M-?E--MX------------E------------------o----E------X-BM-M-----o--?-?-E--------B-------------M--M---B---X--X---------?--------o--------B----X------
-X--?-o----------o----M-o-----------M--X-----o--B---o---E--E-?--M-------------------?---o-------------------------EM-------X----E----------------B--M-------?--------M-----------------MBE--------o-----
-------------------X-------E----X--------?-------------B------?------oB--?--?--------o----M---X-----------------------o-XM-------X----o-B--M----X-B------ME--B---E------?---B----M----------o-E---?-----
-?------B----?------------------------------X-EX------o---------M----E-----E----------------o-------------------M--------------X------EX------------------XM---o---E-------X-X--?---------------E?------
-B------------M----M---------BMM----?----X----------X----o-----E--?----?-----E-----------E--B--EE--B---------B----MM---XX------------?-o---o---------------------------E------E------?----E-X-o--------v
-o??----X--M--------X------E--o--------o---Eo------------B-Mo------------o---------EXE---------X------------o------B----------X-----?o----------------o-----Xo------------MX----B------o------M--------f
-------?----?-------?------B--------?-------B-EM-----o--X-----B?-------X--M----E-o-------o--o----B-B--o------------------Xoo-E-------o-----M-------E----M-o-----X-MB-------?---M--------B----------o-E-f
-----------E--B----o----------?-------------M--?-B-------?X-------o--E-----o--------E-------B--------B--------M-o--------------------------o--E---X-----------------------------------B-M-E-o-------B--f
---M---X------------E-M-------------------X--M---E------------------X------B---------------X----XX--------E----E?----B------------------------------E-----------E-o----------X-------BB-----X----M--M--f
---B---M------------?-B---------o----------?o---------o----------------X--X------------------------------o------E--------?---?oo---B-M-----?---------M-------o---------?----?--B----E-B-----M-------Xo-f
----------?------------o------MX-----E----M----------E----oB-------------------X----E-------------E---BBo?-X------?---M--ME--M---------?-----?--?--------------EM-?----------?-----------X---?------M--f
m----------XM----B-E--E--------------------------X----X-----X---M------------||E------o------------------?-----------------|--------Mo----?------------o--oM----?B--?-----------E-------o---|-----B----X
XXXXXX-XXXX--XXXXXXoXX?BXoX?BXXXXXXXXXXXXXXXXMBoXXXXXBXXXXXXXXXXXXXXoXXXEXXXX-XXXXXXXXX-XXXBXXXXXXXXXXXXXXXXXXXXXXXXMEXXXXE?XXXXXXXM-XXXXXXXXXXMXMXXXXXXXXXBXEXEXXXXXXXXXXXXXXXXXXXEXXXoXX-XoXXXXXXXXoXX
