-----------------------?--------------------o--------------------------------------o-------------------?---------------------E-o-------------------------------------------------------------E----------
--------------------------E--------------------------------------------------------------?-----------------------------------------------E---------o-----------------------------------------o----------
----?--------------------------------------------?----?---------------------------------------------------------------------------------E-----------------------------?-o-------------------------------
----------------------o---------------------?----------------------------------------------------E--------------------------E--?------------------------------------------------------------------------
---o-------------------------------------------------------------?--------?---------------------?-----------------o----------------------------o----?-----------------o---------------------------------
-------------------o------------------------------------------------------------?---------E------------------------?----o-------------?---E-------------------------------E---------E-------------------
--------o---------------------------------------?-------------------------------?--------------------E----------------?----------?-----------------------------------------------?----------------------
---------------E---?--------E---------------------------------------?---E----------?--------------------E-----------E---------------------E--------------------------------------------------?-o-------v
-------------------o--E-?---------------------------?------------------------------------------?-----------------------?------------------E----?-----------------o---------------?---------------------f
------E----------E--------------------------------?---------------------------------------------------------------------?------------------------------------?-?---------------------------------------f
---------------------------?------------------------------------------------------------------------------------------------------?-----------?------?-------------------------------------------------f
--E--------------------------------------------------------?---------------------------------------------------------------------------------------------------?-------------o-----------?------E------f
----------------------------------------------------------------------------------------------------------o---------------------?-----------------------------------------o---------------o------?-----f
--E---E--------------E-----------------?--------------------------------------------------?---?------Eo-----------------o----------E--------------------------------E-?--------------------------------f
m----|---------------------|--------------|-------|---------o----------------?----------E----------?--------------------------------?--------|--o-----------------|---|-------------|---|--------------X
XXXXXXXXXXXXXXXXXXXXXXXXXXXXXXXXXXXXXXXXXXXXXXXXXXXXXXXXXXXXXXXXXXXXXXXXXXXXXXXXXXXXXXXXXXXXXXXXXXXXXXXXXXXXXXXXXXXXXXXXXXXXXXXXXXXXXXXXXXXXXXXXXXXXXXXXXXXXXXXXXXXXXXXXXXXXXXXXXXXXXXXXXXXXXXXXXXXXXXXX
