--------------------------------------------------------------------------------------------------------------------------------------------------------------------------------------------------------
-------------ME------------------------------------------M-------B----------M-------------------------------------------o--o--------------------------M--------?--------------E---M---------------------
---------------B---o-ME------oM------------------------------------------------?------------------------------------?-E----------E---------M------------?--B--------------------o-----------------------
--------o--------------------------------M-------B-----------Eo---------?-------------------------------------M------M------------------E--B-o--------------o----?---------------------------B----------
-----------------------------?------B-------------------------o---E-----------M------------------------B----B-------?-----------------E---------------------------------------------------o-------------
---M-?----------------?--------oM------o--------B------o----------------B?--B--o-------B--M-------------------?---E--E--------------B--o--M-------M----M-------------?----------------------------------
------------o----B------------M---E----------------------?---------------------------M------------------------------------------M-------------------B------Bo-------------------E-----?----?------------
---E-----------------------------------?-E-B---------------?--------------o----------?-------o----?---------E---E----------------------------------------EB---------B---M-------?-----?----------------v
-M?-------------------B-----------M--B?--------------------------------------o-----------E-------------------?--?-----?--B------------------------------------E------------------------------o---------f
--oM-BoMo-------------E-----------------MB---?E--?---------o-----B--?-----BM----Bo--oE----B------?----E-----?-?---?---E--M-----E-B---E-E-----------o-------ME-M-----M?---B---M---E-M-?B---E------------f
--o?-?--?--M---B-----B-o------M-------------o-----E----T-M-----B-B-B-----?-E------------M--?-EE--o----BM?--M-----------o-----B----?-o-B-E-----------?----?-o---------o---E---??--o-o--?---B-?M---------f
----o--oME-----o---?------?-----M----M---B--?--------o-|-----o-o-E-o------------o-o-|-BBTB----Mo-?--M------------?--M-o-?o--M-------------E---B-T----M-E-T?-----o---M--------B---M---o--B-?--E---------f
----E-B--?T-M----o-?---B-------?------M---o-----E------TE--------o--T-T---?-EE--?M--|-o-|--o---M--XX--o-------?--MB---------TB----------o?B--B--|o--T--o-|-X-o--X-o--Xo?-M-?-M-?E---E-o--?T-?----------f
--TT-T-T-B|MBM------?Mo?-T--TTT-----E---?TT-T--T?X--T--|?M--XXT--o--|-|-T---T?-EE-XE|T-o|E-?X?-MT--X------B-----T--E----o---|-T--?----TT-T--TMo-TT-T|B-EX|?EoT-XX---T-X-?--?-----XBEEE---T|-?----------f
m-||---|--|-X--X|--------|--|-|----------|-B|--|-XB-|--|-B-|-X|-------|-|---|---XX--||--|--X|--B|--XX-XX---X-X--||----|-XX--|-|-BX--EB||-|--|--X||-|----X|---|-X-----|-X-----X-X-X-------||--X---------X
XXXXXXXXXXXXXXXXXXXXXXXXXXXXXXXXXXXXXXXXXXXXXXXXXXXXXXXXXXXXXXXXXXXXXXXXXXXXXXXXXXXXXXXXXXXXXXXXXXXXXXXXXXXXXXXXXXXXXXXXXXXXXXXXXXXXXXXXXXXXXXXXXXXXXXXXXXXXXXXXXXXXXXXXXXXXXXXXXXXXXXXXXXXXXXXXXXXXXXXX
