--------------------------------------------------------------------------------------------------------------------------------------------------------------------------------------------------------
-------------------------------------------o--------------?-------------------------------------------------------------B----------M--------------------------------o--------EBE-----------B------------
-----------------------o--------------E------------o------------------------E-o----?--BB--------E--------oB----------------------------?-----------?---------B----E---?---------------------------------
--M----------------------------------E---B-----E--------B?--------?---oM--?------------?------------------o------?------------o----------o----------o----------------M----------------------------------
-o--------------------------------?--?---B------------o----------------o---------E--------------?--------------------o-----------------E?----E-------E-------E---------E----------------M---------------
-M---M-o-----------Bo----------------o-?M--------B-----------------B--------------------------------?-------------------?----------------B----------------M---------------------------------------------
----------??--------o------------?-----------------o--------------o-------------o--------?-------------?---------M-------M-----------------------B-----------------E--o-------------------E-------------
-----------------o--------------------------B-----------------------B----------?------------?--------------?----------------------------------------M---M--B------E--------B---?M---------B?-----------v
-----?-----------E------EE---E-------------------------------------------------------------------------------------------?--M----B----------M--------M------?-B---------?------------------------------f
----E-------------M-oM--------M--E-BE-Bo?--Bo---o------o-?E--o-Mo-MEBB--o--?-----?E--oM------?------E---o--------------?--o----------?--------BE---E---?---BEB---M---?-E----------X----?--M------------f
-----B---Mo-M-----?-MM-----o-------?------?M----B--------M---o-------------E------o----o-E---------XX-E--E----?----E-------?M-?----E---E----E-M---E--M-?--------E---o----------M-X-------o-E-----------f
--o-BoE--oo--------ME--o-E---M--Bo-B-B---------E--B---o---oE----E---E---?----M--?---o---B?-------?XX-----M-M--------M--?---M----MB?E-o----E----?-----------E-------E--M--E-E-o--X--------?-------------f
--E--EXBXX?MB----B--T-------|---TE------MT---B-Xo-o----B--B-B-E-TM-B-----o---B--o-E-B-B--?T------BoXB---X-T-M----?-BX--B--BB----B----o-B---M--E-BE---B---?-----o----ooM---X-E-M-X-----E----------------f
--?B-M-X--XT----T-TT|o-MTT-T|-TT|--?-M-M-|-T-MXB-?XT---BT--E--M-T-|--oBTBM?TT--T-E-o|-TT-T|BT--oXX-X-o?--T---?T-T-T---BoB---T--T-BBT----T-----TX--oM-----T|-TTTE----X---?X-X---T-XT?--XX-X--Xo---------f
m-X--EX--XX||---|-|||--X||-||-||------|--|-|-XX---X|-XX-|-|----X|-|--XB|-?Xo|-X|B-XX|-||-X--|---X-X--|--X|MB--|-|-|--XBX----|--|-X-|-|--|---X-|-XXX--BX--X|-|||--|--B-X-BXX------X|----X-XEXBX---------X
XXXXXXXXXXXXXXXXXXXXXXXXXXXXXXXXXXXXXXXXXXXXXXXXXXXXXXXXXXXXXXXXXXXXXXXXXXXXXXXXXXXXXXXXXXXXXXXXXXXXXXXXXXXXXXXXXXXXXXXXXXXXXXXXXXXXXXXXXXXXXXXXXXXXXXXXXXXXXXXXXXXXXXXXXXXXXXXXXXXXXXXXXXXXXXXXXXXXXXXX
