--?-----------------------------------------------?----------E-----------------------------------------o-?---------E------------------E--------E--------------------------------------------------------
-----------------?----------------?----E---E----------o--?---o-----------?----------?------?-------?------------------?-----------------o------------------------------------------------------E--------
--------------o-?----------------?--------?---?--?-----------------------------------------------------------o-?-E----------------o-----------------------------------------------??-------?-------o----
------------------------------------------------o------?---o------------------------?---------?-----------------?--------?--------E---------?o-------------?--??-?-E-----------------?------------------
---------------------------------?-----------------?-------------------------------?-------------------?-------------------?---------------?----?------------------?-----E----?-------------------------
-----?---?----------------?----?-----------?--?--?-----------------?---------------o--------------o-------------------------------------------------------------------------?-----??-----------------?--
------------------------------?---------o-----o-E----?-----------o--------------------E------------------------?------------------E-------?-?---?-----?-----------------?---------?------------E--------
-----??------------------o------------E-----------------o--------------------?------------?-----E---E----------------E--------------------------------------?----------?--------o---------?-----------ov
------?---o-?--E-----?-?------------E-------?-------------??o---?-----------?-?----------E------?---Eo-----?--o----------o?----?---Eo------?--?---------------??----??---?-------o--?---o--E--?------?--
--E-?--?o--?---?--?------?-E---E--o?---o-------?---------?------o-------------?------------?---E-?--o??-?--?-----E--------------E---??--------?------------E?---o------o-------?-------E--E?-----?------
---------E-?-????-----E-------------???------E--?-----E-o-E--o--o----------?------EE-o-oo---------------?-------?-----E-?---------?----?-----?-------E?--E----o-o-----o?------o?-------o--E-E------o--?-
-----------------o----E--o?----o-EE-E?E-o-----o----E---?---o?---------------------o--E-?-?---E-----------?----??----?---?--------------??-?-----?------------------o-o-------?----o-----E----EE-----o-?-
-o?--?------------------E---?-------o----o--------o?----o-??---o-?-??--?-----o--E--?-----E-------E?-------------o--?---E-----E-------?---o---------o----------?---?------E---?E---?----E?------------E--
-----|----------|--o-?-??-EE-------?-E------|------T---|T--|-?---|----E---------?E-?------T--o--o---?---|ToT--o|--?--?----?-o-?------?-----T---E-??E-|---?|-----o-T---?-o--T?--E-?---E-|E----o-E?----E--
m-|-|||E--E||?|||||||E|||-|-o-||||EEE||--|||||?--|?||-|||-?|-||o-|-|-||--||E||?E|||-|-?|E?|?E||-?--||-|-|||-|o||||o||o|-||-|-?|E?|-E|?||-?|||-?|?|---|-|--|-oE||-||--?|||--||?|--|-E|E-|--||-||-|-?o|||-
XXXXXXXXXXXXXXXXXXXXXXXXXXXXXXXXXXXXXXXXXXXXXXXXXXXXXXXXXXXXXXXXXXXXXXXXXXXXXXXXXXXXXXXXXXXXXXXXXXXXXXXXXXXXXXXXXXXXXXXXXXXXXXXXXXXXXXXXXXXXXXXXXXXXXXXXXXXXXXXXXXXXXXXXXXXXXXXXXXXXXXXXXXXXXXXXXXXXXXXX
