-------E---------------------------------------?-------------?-----------------------------------------------------------?-----------------------------------------------------o-------?----------------
------o-------------------------o--------E-----------------------------------------o-----------------------------------------------------------------------o------o------------------------?----------?-
---------------------------------------------------o?-----------o--------o--------------------------------------------o-----------------------?-----------------------------------------------o---------
------------Eo----------------------------E--------------------------?---?-----------------------------------------??-----------------------------------------------------------------------------------
----?--?----------E---------------------------------------------------------?---------------------------------------o------------------------o------------------E---------------------------------------
-------------------?-----------------------------------------------?------------------------------------------------------?-----------------------------------------------------o?----------o-----------
--------o------------------------------------?-----------------------------------------------------------?-----------------E-------------------------------------------------------o-----------------?--
-------------------------------------------------------------------E----------------------------------?----------E---------------------------o----------------------E----------------------------------v
-------------------o----------------------------------?----------------------------------------------------------------------------?---------------------------------------------------------E---------f
-----------------?-----------------------------------------------?-?---------E------------------------------------------------?----------------E--?----------oE-----------------------------------o----f
-E?------------------------------------------------------------------------------------------?--------------E--------o------------?---------?----------------------------------------------------------f
----------------------------------------------------------E---oE-------------------------------------?-------------------------------------------------------------------------------------?-----------f
------------?-----------------------------------------------------------o------------------------------------------------------------------------------------------------------------------------------f
------------------------------------------------------------------------?-----------------------------------------------------------------------------?----------?----E------o--------------------E----f
m-----|---------------------------?---------------|---|-?----E----|------|-----------------------------------------|------------|-------|?----o?|--|------------------------|-----|-|--------------|o-|X
XXXXXXXXXXXXXXXXXXXXXXXXXXXXXXXXXXXXXXXXXXXXXXXXXXXXXXXXXXXXXXXXXXXXXXXXXXXXXXXXXXXXXXXXXXXXXXXXXXXXXXXXXXXXXXXXXXXXXXXXXXXXXXXXXXXXXXXXXXXXXXXXXXXXXXXXXXXXXXXXXXXXXXXXXXXXXXXXXXXXXXXXXXXXXXXXXXXXXXXX
