--------------------------------------------------------------------------------------------------------------------------------------------------------------------------------------------------------
------------------------o------------------M--------------------------------------------------o---------------o--------------------------------------------M----------B-------------------------o-------
----------------------B---------------------------------------------?----------------------------?---M-----?------------------E------------E-------?-------M--------------------------------------------
--------------E--------------------------------E------------M-------------------------------------------------B-----------------------------------------------------------------------------------------
-------------------------------B----------M------E-------------------------------------------------------M----------------------------------------------o--------------------E--o--E--------------------
-------o--o-------?----M-------------------------------------------------------------------------B----------------------------o---------------M----o----------------?------------------Eo---------------
--B--------------M------------------------------------------------------------B--------o----o---------------------B?---------------M-----------------------------------?---------------------?----------
-----------------E----?--------------------B?--------M--------M-M-------------------------------------------------------------------------------------------------E----------------------B---M--B------v
--------------------------------------------------B--------------------o----------------------------------------------------------?------E------------------o-------------------------------------------
--oE---------?o---MEMM--?B-M----B?-E---E-----BB---E--BBE--Bo------?B?---EEM---o?-?-o----M-E----o-----B-B-----------oE-------E--E-o-------o--??--o-?o-?---M------------?E-oM--------?B-----M-B------o----
-----E--E--EEo-E--o--ooo---?-------MEE-----?-------E--------M--------E----------------M----BM?---M-------------E----MM-Bo----?-----B---E-?--oo?-B-M--?--M----M--------oEM-----o-----o?B-E--??E-o--------
---E--?-----?M------B-----B-o-B--oB-----??----B---B-------M--X----oMM-E-o---------o---ME---?B-ME--------o------E----?o-----------E----o-----?-------EoB-----MM--------BE--E-M---?---MM-----?Moo---?M----
-----------------?----B-------M--B--B-EB--E---E-B---?E-----XB-X-B--M------Eo-----o---MM--E---------o----M---BB------E----E-EB-?M-oB-B---?--o-B--E---------M--------------o---------?--B------EE--E------
--------------------X--o--E-X-----ooEo??-M-oo-----oo-B-----Xo-Xo---M-M-?--?-B--------MXEM-EX-?-B-----B---o---------X?----E--?----?-oo--M---B-B-E------------o?--o-------?M-BXMM----E-----X---------E----
m-oB---?E?-----o----M-------X?-------------o-XE-?---E-------X--X---X-B--EM----MX----oX------X--X-----M--E---XMX----oX--?-------o-M-XB----EE-X--------E-------B--MM--o|o-----XMXo?-EX---X-X-X--?o-E--B---
XXXXXXXXXXXXXXXXXXXXXXXXXXXXXXXXXXXXXXXXXXXXXXXXXXXXXXXXXXXXXXXXXXXXXXXXXXXXXXXXXXXXXXXXXXXXXXXXXXXXXXXXXXXXXXXXXXXXXXXXXXXXXXXXXXXXXXXXXXXXXXXXXXXXXXXXXXXXXXXXXXXXXXXXXXXXXXXXXXXXXXXXXXXXXXXXXXXXXXXX
