--------------------------------------------------------------------------------------------------------------------------------------------------------------------------------------------------------
----------o------M?--------------------------EM-------o---MB?-BB---------B-------------B-E----------B----?oE----------oB--B--BM-B-----M------??-------B-M-----o----B-M----?--M-----Eo-------------------
-----------------B----o-------M-----------E---?-o----------------?---------o-M-------?-------------o--------M---------------------?--------------------?---o----o--o--B---B----------o--?o--------------
-E-o--o-?-B---------------------E-----------oo?-E---------o---EE---E-----?--------------?-------E----M---B---MEE-------o------------M---E--o-MM-E--?----------------------?---o-------?---B-------------
----E-------------?B-B-?-EM-----E----B-oBEE------M-----o--oE---?-------o----MBEEE--B---?-----?----?-------------o---B---?-?---?---E------?-M---------B-o-----o---?--?--B----?--?-E----------E?----------
-----BE------?--------?o-?----B---BBB-----------E----B-o------?----------M---E-----M-----E---o---Eo----------?-E------BM----?E---M----------E-----------------oBB--E--M--------E-B----------B-----------
--?-------?-M----------?-----B--M?------M------Mo-----E---------------M------E-o-------M---------o?------E--E-E--------E-----M---------------o-?-M?-E----------E-----B----??B-EM-----B-MM----E----------
---------?---M----------?---MEoM-------MB?-B-?--E----B----M---M------E--B----?----?-----?---------o----------------?--??-B-o----o---M-------------------B-?-o-------BE?------o-------o-----|-----------v
-?-?------E----B--M---M-----o----Mo-E---E---------o------o-EM-E-----------------B--M---E----M-----E-----B---o----M-----B--??E-?--------------B-M----------E------oM---------?-E-M----------|-----------f
---B---------------EE----M-------------E--B?-----?--------B-?-M?o---------------?-E------------X-B--o-----?-E------BX--------------o--o---?oo-----?--M?o--------B---B-------o--?------?-B--|-E---------f
------Bo-----MEB---B-B-----?----o---o-BB--E-------------B--?---B-?-----?----B-----E?-----------XMB-?-?-o--E--B-E---X----??---B----E----------?-?--M---?---M?--?----ooBo-----?B-?----M---EM-|-M---------f
----ME-??------B---B-----------o--?B-Eo----o------E-----MM-------M------EM------|------o----o-X?-------------BM--BE-X-MB---oBE---o----?B---o?-----E--?-oM--------E----?----T----E-oMTM--M--|?----------f
-----M-------Bo---|-o-B-B--T|---|?B--?|----|-----?ooM---|---MT?o--T-------?---oE|----E--EM--?-----TETo----o-E--|-M----MT----o---TM-ET?----|----|--o---|-XE---E-o--M?B|-----|M-E-EEM-|---B-X|-|---------f
----o---|-TE---MTT|---TM-|-T|---|-MX-?|---B|?TTo|--ToTE-|-|--|--E-||-BT-?B-XXoMT|-B-T---|--oX--T|-|-|o--X?-T|--|-|--|-X|-|B---TT|-|-|-T--T|-TM-|---|-T|-EX--|-B---E-E|--TTB|---|---T|MT-MXM|-|---------f
m|-||-|-|-|-||--|||oEX|--|-||-E-|--XX-|-|-X|?|-||-o|-|--|-|-B|-XBX-||-|--oXX-XX-|-|--|--||-|-XXB|?|-|--|-X-||-M|-|--|-X|-|--|---|-|-|-|---|-|-X|---|-||oX|--||--E-|-?|--||MB|-X|-|-X|?|-|-X|||---------X
XXXXXXXXXXXXXXXXXXXXXXXXXXXXXXXXXXXXXXXXXXXXXXXXXXXXXXXXXXXXXXXXXXXXXXXXXXXXXXXXXXXXXXXXXXXXXXXXXXXXXXXXXXXXXXXXXXXXXXXXXXXXXXXXXXXXXXXXXXXXXXXXXXXXXXXXXXXXXXXXXXXXXXXXXXXXXXXXXXXXXXXXXXXXXXXXXXXXXXXX
