--------------------------------------------------------------------------------------------------------------------------------------------------------------------------------------------------------
-------------------------------------------B------------------------------------?---------------------------------------E------------------------------o---------------------------Eo-------------------
------------------------------------------------------------------o--o------------------------M--------M--------------------------------------------------------B---------------------------------------
-----------------------------------------------B------B-----------------------E-----------------------------------B------------------------------------E---------------------------------B--------------
-------------------------------E-------------------------------------------E-----------------------?---------B--M------------------o-?----------------------------------------------M----o-?---o--------
-?-?--------?------M---------------B----------------------------------------------------------------o-----------------------E-----------------o-------------------------------------B-------------------
--------?--M-----------------------------------------------M-------------------------------------?-----------------------------B------M------B-----------------?--------E----------o--------------------
-----------------?--------------------------E---------o-----------Eo---------------------------------o--------------------------------------?---B----------------------------------------------------o-v
--------M----------------------------------------B------------------------------------------------------------?---------------------------------------------------M--E--Mo------oo------------------M---
-----?------E--------MM--o-------B?-E----------M--?M---------o----BE?oB-B-oBB-B---Bo------M-------?-E--EE----------------B--BE-B-----o--oo---BB--o-----M----B--E----B---E----B----BM-----M-E-E----------
---------------------o-------M--------oo-?-?-?------B-------BM-------M?--o-?----------?----M---M--M--B-M---o-------o--EE----------o---o-M----M--M---M---B?----BBE----B------B---?--M-B----??-B-------M--
-M--o---------B--M--B---------o---o?-----MM---?----?-------X--?-B----E-MM-------B-------E--o----M-E-E-M-------------------?o---oM-----?------------B?---B--------------------E-BEM?-o?-B----------?--?--
-?------o?-o-----E--Bo-M-------oMM--EM-------?-o----E?MM--Xo-B------oo-------M-MB--MM-B--Mo---M---??-oEX--B--B??B-M--MMB-BoX------------------------M--------B---M-M-M----oE-oM--o--M---oE--M---M-------
-----B-----B-------M-X-----E---XXXE------o---E-------?--EXoM-X---------Mo---o----?BXEXM---Xo--------B-oX-o-------XE-oEXEo-X------E---M-X--------B------------oM--------XB?--?E-------o--M?BXE?--B--M----
m-E-----------X--M---X-E-o---B--XX---XM----M-?----E-o---X?---X--X----X|?X---?---EM--o?X---X---XB?--o----X-M-X-?X-EX--o-XMX--M-?-M-----X---?-----MB?-?----EX----------B--X?-?o-Mo-X---M-X----X---?E------
XXXXXXXXXXXXXXXXXXXXXXXXXXXXXXXXXXXXXXXXXXXXXXXXXXXXXXXXXXXXXXXXXXXXXXXXXXXXXXXXXXXXXXXXXXXXXXXXXXXXXXXXXXXXXXXXXXXXXXXXXXXXXXXXXXXXXXXXXXXXXXXXXXXXXXXXXXXXXXXXXXXXXXXXXXXXXXXXXXXXXXXXXXXXXXXXXXXXXXXX
