--------------------------------------------------------------------------------------------------------------------------------------------------------------------------------------------------------
----------------------------------------o---------o------------------------------------------------------------------M-------M------B---o-----------------?---------------------------------------------
----------------------------------------------------------------------------------------------------------------?----------------------------------------------------------------------------------?----
--------------------?-?-----------------------------------------------------------------------------------------------------------o------------------------------------B--------------------------------
----M--------------------------------------------------M------------------------------o------------------------------------------------------------?----------------------------B----------o------------
------------B--------oo------B---E-----------E---------------------------E-------B-------------------o-----------------------------------------------M-----------------------?--------------------------
-------------------------------------?--------------X------------------B-----------o--------B------E--------------?---------M---------------------------M----------------------------------B--B---------
------?-------------------------------------?-------X---------------B------M------------------------------M---------------------------X--------------X---------------------?---------------------------v
------------------X--------------------------------X--X-E--------X--------X--------------------------------------------X----M--------?-X-X------o-----X--B----------------------------------------------
--XXXo---BXX-o??E-XXo-o-E---?X--XXo-o--oo--?E-o-X?XX-X---XEXX?-X-?X-X-?---XX--X--------------?XX---?------o-----o----E-XXXoX--o-X------X-X-?---EX--?--X-XXXXE-XX-?X-X?---E--XEX-E?E---X-EX-E-o-XX---?---
-ooXE?---EXo---o--X-XoX-X---?XXXXX---?----E-X-XXXX-XXXXXX-XB-XXX----?--?XXXEo?-o----?-----?-E-XE--E-----------------o--X-XX-?--BEXX-----XX-X---XX--o-o-X-X-XX?X-?-X-X?-XE---X-EXXE---XXoX-?--XX-X--o-?--
--X?--?---oXXo----X-X-X-X-o?-X?XXX-???--XX?X-XXXX--?-XX-XBoEXXX?-?------?XEXX--?XEo------?--?XX------?------------E---XXXX----Eo--------X-X-X-?-XE---?-XXXX?-XXX-??XXoX?-----X-?X----X-?X----XX?----?---
--X----X---XX-X--X?--?XE-X-XXXXX--?o-o-?XXXXoXXX?oXXXXMXX?XX-XX?---XE-?E-XX?--XX-XX--o?---XXXX-o------------------X-XX?XXB--E----XX-XXXXXXX?--X-X?XXXXX?XXXXXX-XXX-EXXX-E--X--XX?X-BX?XXB---o-X-o-------
---X----X---XXXBXE--X--X?XXXo-XEXoXoX--XoX?X?XX-XM--X-?-XE-XX-X-----X-?XXXXoEXXXXXX-XX-----XX--XoX--E-----o-X-oXE-BXXE-XX-??o-?-?-XXX-XXX-XXXXXX--X-X-?XX-?-X?X??XX--X-E---X---XX-o-XXXoEE---M-X--?XEX--
m--XX-XoXX--XXXMXo-?X-XXXXXXX-?XEX-X-?E-X-XX--X--X?|X-?X--XXE-X---??-X-XXXXXXXXX--X-X-Eo--?-XXXXXo?--?o-?--X-?-X-?-X-X?-XX-X-----oXXX-X--?XXX---oEXXEX-oX-X-XXXX-X---XX--o--X---X-M-Xo?XX--?E?-X---X-X--
XXXXXXXXXXXXXXXXXXXXXXXXXXXXXXXXXXXXXXXXXXXXXXXXXXXXXXXXXXXXXXXXXXXXXXXXXXXXXXXXXXXXXXXXXXXXXXXXXXXXXXXXXXXXXXXXXXXXXXXXXXXXXXXXXXXXXXXXXXXXXXXXXXXXXXXXXXXXXXXXXXXXXXXXXXXXXXXXXXXXXXXXXXXXXXXXXXXXXXXX
