--------------------------------------------------------------------------------------------------------------------------------------------------------------------------------------------------------
-------------------o------------------E--------o--------------------------------------B--------------------------------------------------?--------------E-----------------------------------------------
-------------o---o----------------------------------------------------------------------------------------------E----------------------------------------------E------------------------------E---------
------o---------------------------o------o--M---------------------------------------------------B--o-----?-o-----o--------------E---E---------------------------------B------------o--------------------
--o?-------o------?---------------------------------oo---------------------------E---------------------------------------E----------------------------------------------------B---------------------B---
----o---------?-------------------------B-------------------------------------?------------o----------?-------------------------------------------?----------------------------------------B------------
---E--------------------o----------------------------------------E-B------------------------?--------------------?---------------------------E--------------E-------------------------------------------
---------------------------------------------------------------E-----------------?---------E---E--o------------------------------------------o---------------------------------------------------------v
----?-------------------Bo---------B-?-----------M--------M------------------------BB-----M-------B----------------------------------------------B-E--------------?--------------------E----------------
-------oXoX-M?----B--?-oXo--?---o-M--E-----------?E-----------B----M--E-----?-E------oM-----ME-?--E---ME--B----B--B-X--o?--------E--M--------M---------M-------o-----?BX-M---E--M--------B-o--?------B--
--E--E-B-X------B-o-o-oX--?-E-?------E-B----M-?----M--?-------E--M----EM---B--oB----X?-----?----X--------BM----E-B-XEBB--?M--o-------oE-------------?--------M?o-E--?o?X--X-??X--M------oME--o--B-?-M---
-------M-X---XoE-----o--XB--X-E---M----??-----M--?o-?-----E--oo-B-M----E--o-M-?-----?XB-------X--o-----E--B---?--B--X?B--?E--M-M-----E?B-M--M--M-M--B?--------?-E-----X-B-EXXXX-XXX--o?o-M------E---B---
-----E--EX--M-XX-E--?------oEX------M-------X---B---E-BE--X------?oE-?----?-------E-XBX----?E--XX-E--E---Eo--E--B---X-----o-oM?---------X-------M-X-------?--oB-BE-B-?-X----X-XX-X-M-B-M-------EBM------
----BB--------?X-Bo----B-XX?-X-M-?------M-E-oX?-B?--ME--B-XX---?XB-XX-MM|BEBE----X--XMo-XX-----X-??--------EM---E-EXX-oE-?---E------E-o-X--o-----X--------MoX----E-B-E-X--o---XoX---MX-EEM---oB--B------
m---o--M-XM?-X-XX-X-E-X-oXX--X--M?XM-o----o?X--M-E|o---EXXX---B-Xo--XXBX|X--------XB-X--X?---XXE-X---o--MX--M-BE|XXX-----XX----EE-oBX|o-X--X|?-M--X------B-X?-?XE--?---X-X?-M-Xo-Bo--BX--E--XXX--?XX-X--
XXXXXXXXXXXXXXXXXXXXXXXXXXXXXXXXXXXXXXXXXXXXXXXXXXXXXXXXXXXXXXXXXXXXXXXXXXXXXXXXXXXXXXXXXXXXXXXXXXXXXXXXXXXXXXXXXXXXXXXXXXXXXXXXXXXXXXXXXXXXXXXXXXXXXXXXXXXXXXXXXXXXXXXXXXXXXXXXXXXXXXXXXXXXXXXXXXXXXXXX
