--------------------------------------------------------------------------------------------------------------------------------------------------------------------------------------------------------
--------------------------------------------------------------------------------------------------------------------------------------------------------------------------------------------------------
--------------------------------------------------------------------------------------------------------------------------------------------------------------------------------------------------------
--------------------------------------------------------------------------------------------------------------------------------------------------------------------------------------------------------
--------------------------------------------------------------------------------------------------------------------------------------------------------------------------------------------------------
--------------------------------------------------------------------------------------------------------------------------------------------------------------------------------------------------------
--------------------------------------------------------------------------------------------------------------------------------------------------------------------------------------------------------
-------------------------------------------------------------------------------------------------------------------------------------------------------------------------------------------------------v
--------------------------------------------------------------------------------------------------------------------------------------------------------------------------------------------------------
--?oEoB-M--MB-----------M-?----EM------X--------?X----M---o----oM----B--B--MM-----E-----B-----E----EEX-------?---------E--o?-E-?--B-o--E---M-B--M---oo------BE-----BEB--?--------BM--?------MB-----E----
-?o--BMX----M------?---E-M--------?--E-EX---B--EXX-----------?--o-----E?----E-?--E-------------M----XMB-B---E---M---------?-E------B----E--B---------?------oBE---------B-B-----?---MX----?--------oB---
--E--?X--E--------------MM?--o-----E-----X?M-BooXo------E----B-----E---BEo------M---B--?-o?E--??----X--M---??--------M--B----o--M-----M--------EMM?---------------o-----o----B---BB---X---o-MB-------?--
--M?--X-o-?--B------------E-B-oBX-B----EX----B--X-X-E-------BXE---?--EE---M-Xo-----B----E-M--X---?---X---M-------?--E--M-B-o--o-X-----?--M--E----E---E--oE-----E-------M-M--o----o---X--M-Bo-B--o--?o---
--Mo-X---?--?-B----------------X------?X------M-oX-E--MM---BX--XXE------X-XX--B----oE-----XMooXX---?--X------E-M----X---X-E--XXXMo--EB-o---E----B---?BM-?------M----M-E---o---------BXo?-Mo---E----X-?--
mM?---XoEX-Xo?XoBB--X-E?E-M?oMXEXo-o--MX--XXMX--X-M-XM?X-XM-EX--X-X--X--X-X-X-XoBMX--B--X-X---X-X---X-X--M-oo-EXE-MXMo--X---B-X--X--MX-?--M-X---B------X---BM--?-B---XM-------E--?--oX??XXXXo---?-B-X---
XXXXXXXXXXXXXXXXXXXXXXXXXXXXXXXXXXXXXXXXXXXXXXXXXXXXXXXXXXXXXXXXXXXXXXXXXXXXXXXXXXXXXXXXXXXXXXXXXXXXXXXXXXXXXXXXXXXXXXXXXXXXXXXXXXXXXXXXXXXXXXXXXXXXXXXXXXXXXXXXXXXXXXXXXXXXXXXXXXXXXXXXXXXXXXXXXXXXXXXX
