--------------------------------------------------------------------------------------------------------------------------------------------------------------------------------------------------------
--------------------------------------------------------------------------------------------------------------------------------------------------------------------------------------------------------
--------------------------------------------------------------------------------------------------------------------------------------------------------------------------------------------------------
--------------------------------------------------------------------------------------------------------------------------------------------------------------------------------------------------------
--------------------------------------------------------------------------------------------------------------------------------------------------------------------------------------------------------
--------------------------------------------------------------------------------------------------------------------------------------------------------------------------------------------------------
--------------------------------------------------------------------------------------------------------------------------------------------------------------------------------------------------------
-------------------------------------------------------------------------------------------------------------------------------------------------------------------------------------------------------v
-E?----??--------?-----o-----------oo--??--E--?----------o-----o--?-??----E----o---o--?-?-----o--o---?E-------?-----?--?----------?-------E-?----?o--o----?-E-E----o-?----E-?--?-??--E----o-o-?-----?---
-?------??-?-------o-------?---------E?o---E-------o--?----?o----o--------o-?-------------o------?--------E--o------------o-----------?-?-E-----?------------------?--?-------o--E----------------------
-o------?--?---E-E--E------?E?-?---------?E-----E------?--------o-----o--------oE-------?-----?-?-?----------------------------------o-o-?------o-?--?--?---------EE-------?---o-o-E---------?--o---?---
---E----------?--o-oo?----?----o---?---------?---E--??-------------o--------o----?-E---EE-o-----?--?-----------EE-------EE------E----?-----o----o--E----o--EE---??------?---?-E----?-----?--E--?---?----
-----?----o-----------------------?---E??-?-----------E--?-----o---o----?--???----------?---o?o?------------E---?--E-----?----?----?--E---Eo----?E-o----E------------?----------E--------E-----?E-----E-
----?---?--EE--?---?--E---?oE--E--------oE--o------?E?----E----------?-o?o--?---------?E-?-?E-----?-?------o------E----E----E-??------------?-E----?E------?E-E?E??-------?-----?---------o----------?E-
m-||X--|X?|-X--Eo----X-X-|X-|E-X-|o-X--XXXEX--X?X-oX-----XX-EX-|-X-X--XoX-|------|X-oX|XXoX-??|---X|-|E-?-|--?---|o-X-X?o|oX--?---oXX--X-X--X|XX-XX--X-oXoX||-X?X----|---X--X-X?X|XoXo-EX-|?X-o?-X----?-
XXXXXXXXXXXXXXXXXXXXXXXXXXXXXXXXXXXXXXXXXXXXXXXXXXXXXXXXXXXXXXXXXXXXXXXXXXXXXXXXXXXXXXXXXXXXXXXXXXXXXXXXXXXXXXXXXXXXXXXXXXXXXXXXXXXXXXXXXXXXXXXXXXXXXXXXXXXXXXXXXXXXXXXXXXXXXXXXXXXXXXXXXXXXXXXXXXXXXXXX
