--------------------------------------------------------------------------------------------------------------------------------------------------------------------------------------------------------
---------------E---o-----------------------------------------E--------------------------------?-o-----------?--------------------------------------------------o-------o--------------------------------
--------------------------------------------------E----------o-----------------E-----------------------------?----------------------------------------------------------------------------?-------------
------------o-----o--?-----------------o------------------------------------o---------------------------o---------------------------------------------------------------------E--------------E----------
-----?------------------------E---E--------------------------------------------------------------------------------------------------------------E------------------------------------------------------
--------------------------?----------------------------------------------E----------------------------------------------------------------------------------o--------------------o----------------------
-------------------------------------?--------------------------------------------------------------------------------E-------------------------------------------?---------------------------------?---
-----------------------------------?---------------------?----?--------------?---------------------------------------------------E---------------------------------------------------------?-----------v
---o----------------------------------------------------o------------------------------------------------------------------------------------------------------------------o----E-----------------------
---?-E-?o--?--?-?--?--?-?--oo--------E-o-----E------?-------------o-----E---??E?------E-------??----?--?E-EE----?--E--?-??----?--oEo-?-----?----------------oo----?--------?-?o-------?o-o-----o-?------
-----o--------E---?-----o-------??o?--------------E-----------------o-------------E---------------?--?-----??-?-----E---o---?-----?--??----?---E------E---E------?-------o--------o--o------------XXX?--
---o----------o----o----------------------E---o--o--E-?-o?---?------?----------------------?--------E---?----o------o----o----------oE----?o?-E--Eo----o?-?----o--?E------E?---------E--o-------E--X-E--
-----------------------E----?----------------------?--?---??---?o-?--o---?-----o----------E----------------o--?-------------T----?-----??---E-----o-----?E--?----?-------?o----?---Eo----?----?----EX-?-
----TX-o?---E-E-T-----------------------?-?-?--?---?-E-?---?--o---?-E-oT-o-T-X-o-----------?-T--?----?-To--?o----?-------oTX|-o--TTE-------?--?----Too-?--E---------------Eo-----T---o-------?-?-E--?XX-
m---|XX?--?E-?--|------------X--X---o--?-?|??-------------E-------?----|-E-|--X---------?----|-------o-|-----?-----??o?oX-|-X----||-E--------?o?-o-|-E-|-E----E-----?--Eo-X-?----|-X---?---?-------E--X-
XXXX-XXXXX-XXXX?XX?XXXXXXXXXX-XXXXXEXXXX-XXXXXXXXXX-XXXXXXX-XXX-XXXX-XXXXXXXXoXXXX-XXX?XX-XXXXXXXXXXXXXX-XX-XXXXXXXX-X?XXXXXX?XXXXXX-XXXXXX?XX?X-XXXXXXXXXXoXXXX-XXXXXX-XXXXX-XXXXXXXXXXXX-XXXXXXXXXX-XX
