-------------------------------------------------------------------------------E----------------------------------------------------------o---------------o-------------------------------------?-------
-------E-----------------E-------------o-----------------------------------------------------------?----------------------------------------?---------------------?---------------?---------------------
--------------?----o-----------------------------------------?------?-------------------------------------------------------?----?-----------------------?----------------------------------------------
-----------------------------------------------------------------------o--------------------------------------------------------------o-----------?--------?--------------------------------------------
-------------------------------?---------------?--------------------------------------------------------------------------------------------------------?-----------------------------------------------
-------------?--------------------------o-------------------------------------------------------?-----------------------------------------------------------------------------------------E-------------
------------------------?------o--------?-----------------?----E----------?----------------------------------------------------o-------o-------------E--------------------------------------------E-----
------------------?---------------------------------?------------------------------------------?-------------?-o-----------------------?----------------------------------?----------------------------v
----------E---------------------------o---------------------------------------?--------------------------------?--------------o-----------------?-E---------------------------?-------?----------------f
-?---------------------------------o--------------------------------------------?--------------?--------------------------?----E---------------------------------------?-------------------------------f
--------------------------------------E------?-------------------------------------------E------------?---------------------------------------------------------------------------------------E--------f
---------------o---------------------------------------------------------------------------?------?-------------------------------------------------------------?--------------------------------------f
----------------------------------?---------?----------------------------------------------------------oo---------------------------o----------E?------------------------------------------------------f
-----------------------------------E--------------------------------------------------?----?---------------o-----------------?-----------------o--?-----------------------?---------?-----------------?f
m----||-----------?-||--------------||---------?---|--||-------------------------|---|--------|-----------------------------------------|--------------|-------|-----------------------?----|----------X
XXXXXXXXXXXXXXXXXXXXXXXXXXXXXXXXXXXXXXXXXXXXXXXXXXXXXXXXXXXXXXXXXXXXXXXXXXXXXXXXXXXXXXXXXXXXXXXXXXXXXXXXXXXXXXXXXXXXXXXXXXXXXXXXXXXXXXXXXXXXXXXXXXXXXXXXXXXXXXXXXXXXXXXXXXXXXXXXXXXXXXXXXXXXXXXXXXXXXXXX
