--------------------------------------------------------------------------------------------------------------------------------------------------------------------------------------------------------
--------------------------------------------------------------------------------------------------------------------------------------------------------------------------------------------------------
--------------------------------------------------------------------------------------------------------------------------------------------------------------------------------------------------------
--------------------------------------------------------------------------------------------------------------------------------------------------------------------------------------------------------
--------------------------------------------------------------------------------------------------------------------------------------------------------------------------------------------------------
--------------------------------------------------------------------------------------------------------------------------------------------------------------------------------------------------------
--------------------------------------------------------------------------------------------------------------------------------------------------------------------------------------------------------
-------------------------------------------------------------------------------------------------------------------------------------------------------------------------------------------------------v
--------------------------------------------------------------------------------------------------------------------------------------------------------------------------------------------------------
------?----?-----??-----oX-XX--?-----o?XXo-------X---oEoX-X------?o-XX?oo-o----E-o?-X--E------?-----?---?-----XXoEX?o--E---------E---?--?X---?---E---?--?----------?----E---X---?XXX--XX------------o---
----?--o---------?-------X?X-----E--XXXX-------?-Xo?--X--X---E--o----X---?----?o--X-Xo-----?-------E-------?---XX?-X-E-?XX---E-X?------?XX---?---?---?------E----o-E---?XXo--X-XXXX--EX---o-------E-----
------?---------E--E----E-Xo--?o-o?--XX---E--??-?-XX---XX----??------X--?--XX------X?XE-o----------------E------X--oX--?XX?--X-X--?--o--X----X-?-----??---?o-?---------?-X---X-XXX--o-X-----------E??---
--------------oX-EE--?----EXE---E-EXXX----?-??---?-X--?-X?--?--E---?XE-o-E-XXX?-???X-X---------X?---?----?-------XEX---E-X---EX-?-?--E-X-X----XE-----------XX-?--?--XXXXX-?-ooXXX----XX-------o----X----
---?---o?-----?X--?--EXEX--X--?-o--oX--oXoX--X-oX-X--?--X?-?--oX-----X----?XX-X-X-XX--XXX---o-X--??--X--oE------E-X-E?-EX-E--?X?o-E-E--X-X---XXXE--------oEXX-X-----XXXX---?XoXXX----X------??---?-X?---
m-EX----?---XXX----?EXXXXo?X?XXE-----X--XXX-X?--XX-?EXXX?XX-XXXX-?-?X----?XXX-X-X-X-E-?XX-X--X-XoX--X-XX?X-Xo----X-X?ooE-X--oXX-XX--X-X-X--X-XX--o---X-X?X--X-X-??-oX?X-?E-XXXX-X?--XX---?-?-XE---XXX---
XXXXXXXXXXXXXXXXXXXXXXXXXXXXXXXXXXXXXXXXXXXXXXXXXXXXXXXXXXXXXXXXXXXXXXXXXXXXXXXXXXXXXXXXXXXXXXXXXXXXXXXXXXXXXXXXXXXXXXXXXXXXXXXXXXXXXXXXXXXXXXXXXXXXXXXXXXXXXXXXXXXXXXXXXXXXXXXXXXXXXXXXXXXXXXXXXXXXXXXX
