--------------------------------------------------------------------------------------------------------------------------------------------------------------------------------------------------------
-----------o---------------o-------------M------E----------B---------E----------o-----EM------M----------------------o---------o---------------------------------?---?--------------M---o---------------
---?-----E--------M----E------------------------------------------------------E-------------o-------------------------------?-Eo-?----------------E---------------M-------------------------M-----------
----------------------EM---E----------------------------------------------oB-?--------E------------------------?---------------------?-------------------------------?-----------------E-----B----------
---------------oo----------------------------B--?----M-------------o----------------------E-------------?-------------------------------?-----?------------------------?--------------------------------
--E-------?-----E--?----------E-----------Bo------------------------------o----------------------B--------------?---M----E-----------B-------?-------E----E---o----------------------?------------------
----------o-------o---------------E------------------------------B-----B------------?--------BB-----E-o---------------M-EB--------E--?---B-------------o-------BB----------------------o----------------
------------M--B-----------------------------M-----------------------------B--E-------------------o-------------------------------------------------------------------------?----------M-----?---------v
---------------------------------B---E------------------------M-------------------------------------?-------------------------E----------------------E--------------------?-----------------------------
----M-??B-oB-----------oXBBM--E--oM--E--o-B-o-?-E--?----M-B----E------o----EE-B-M-?--o----E-B---M-?-MM?-Eo-B--Eo---BB--------M--M--?---?o-E-?-M--B----------------?B--E---E-o----M----?--o-o------------
-----B-X-------?----o-------------------??--M---------B---B?B?-------BB--------------M---E-E-o-----E--o---MoB---------M?-B----------M----------?E---E-E----BB-------?----MEo?Bo-----o----?-E------------
---EE-?MX------M-----oE--XM-o--?--XoB---E--o-------o---?---E-----B--ME---------o------M--o-o-----o--oo-------M------o---o---B-M------?--o-B--BB----B--EoM---------E-EB-----?o---?-MoEM--o---T-----------
-?XB--XX---BTM-E---oTT---EB--EBo--XX----B--|----T?---B-?-E----o-|-oM-M----M?-BME-o------EMME--M--------Eo--B----EB---B--??-TE--BE----E-o--M|-----?-?--E---o----?-?------TB----Bo-------MX--M|T----------
-TTX-|-X|-XE|---T-T-||--X----?X-EX-X--X-T|-|-TTM|B---T---T-TTE--|--T?T---BTT?oo--T?----B--T--TT?-------X-||-----TTT----EETT|-To-X-XTE|--B-T|-X-o-T----B--E-o----E--X-MBE|-E------?--o-X-o---||----------
m||-X|-X|--X-|--|-|-||---XX---XBXX|-|--XE|-|-||-|---X||--|-|||-B||-|-|----||--X|-|--X----X|B-||------||--||---|-|||-XX|-X|E|-|--X-X|M|--|-||-|-X-|-----|-B-|-|-----XXX--|-|--XX|-|-X-XoX-|--||----------
XXXXXXXXXXXXXXXXXXXXXXXXXXXXXXXXXXXXXXXXXXXXXXXXXXXXXXXXXXXXXXXXXXXXXXXXXXXXXXXXXXXXXXXXXXXXXXXXXXXXXXXXXXXXXXXXXXXXXXXXXXXXXXXXXXXXXXXXXXXXXXXXXXXXXXXXXXXXXXXXXXXXXXXXXXXXXXXXXXXXXXXXXXXXXXXXXXXXXXXX
