--------------------------------------------------------------------------------------------------------------------------------------------------------------------------------------------------------
---------------E-------------------------------B-----------M---o?----------o---M------------------------------------M---------o-----o--------------------------------------------------------------o----
------E---------------------o-------------------------------------B----------------------------------------------------o---------------------------?---o--?-------------E---------------------?-M-------
----------------M------------------------B-o-----M-----------B--------------------------------------------------------?-----------?---------------E-----------------------------------------------------
---------------o--------------------------------------------------------------------------------------B------------------------B--------------?----------------------------------M----------------------
----------B-------o---------?------o----?----------------B---?-----B---------------------M---------------?----------------------------------------M------?----E----------------E---------B-----------E--
---------------------M----o--------------------------------?------------?---------------------------E------------------------------------------------------------------E------------------E?------------
----o------------------------EM--B---------?----X-------------o---M------------M----------------------------------------------?----------M-----------------B-----------o-------------------------------v
---------------E---------------------------------X--------------X---------------------------------------------------------E------------------------------------B-------------------?----------o---------
---XX?----?---?-----?--------------X-E---------o-?X--X----------X-X-XX------XX---o-----o-?-------oEXX-----E-------E---E---?--B----o---X?Xo-EE----?---EX-?----?X----oX?-------?--?--X-X----E-X-----?-XXX-
---XX-X---------?-??XXX--??--oX?B-?EXX--o----?---EX?EX?--o--Eo---XE-XX----?-X--?----o-----------X-XX---B----?--?-----??---oo---------M-XoE----?-oXE--?X??--?---XE-Xo?X-E--------EE-?M?X----XX??oE?EXXX--
----X--------o-E-?XEXXX--?---X---E-XXX------X-E?--XXX-E----E--Eo-oX-XB?X----X---------------X-EB-X-X--X-?-----o--o-----?o---?----M----?-X-----?-XE-X-XX----o---?X?X-?X----------?E---XX---?-oE--X---Xo--
-----X--EEo----XoX--TXX----oX--?---?X----?XX-X-XX-oXE-----T?----?-X--XXXX--XX------M--M--o-E-X-??-XX-?X-----oo----X?----E---------?---?--EE?---XXo?-XX--o-------?X----X--------o--X--?X-X-o?X-X--X?XM-X-
------X-E----?EXXM--|-X----X---?T-M--X--E?X-EXXX---X--?--TT--XX-X-XX-X-X?--X-??----E?T-?-E---|Xo-XXX-XTT----E-?--XoXXB---?T--E-E-M--MXE-Xo--o--X-TBEXX------?--?-oX-X?-XXE-E?---??-X--?-XX---XX---XXXX--
m--Eo-X--E-?---?|EE?|-oXX-X--E--X?--XXXo--X-E?XX---X-XX--||--X-XXX?X|-X--|-X--|----|?|E--|-XX|Xo-XEX-X||-X-o-XE-XXX-|XX-M-|???M---X-M?|X-??XM-?XX|X?BX--X?--|XE?---XX|-?X-X-o?-o-XX--E--X---XXX-??X-|X--
XXXXXXXXXXXXXXXXXXXXXXXXXXXXXXXXXXXXXXXXXXXXXXXXXXXXXXXXXXXXXXXXXXXXXXXXXXXXXXXXXXXXXXXXXXXXXXXXXXXXXXXXXXXXXXXXXXXXXXXXXXXXXXXXXXXXXXXXXXXXXXXXXXXXXXXXXXXXXXXXXXXXXXXXXXXXXXXXXXXXXXXXXXXXXXXXXXXXXXXX
