-E-------------------------------?--------------------------E-------------------------------------------------------------?-------?------------------------------------------------------------------E--
----------------?-o---------o---------------------------E----------------------------------------------------------------------------------------E---------E--------------------------------------------
-----o-------------------------------------o----------------------------------?----------------------------------------------------------?--------E--------E------o----o--------------------?-----------
-------E------------------------o?-----------------------------------------------------------------o-------E--------------?--------E---?------------?---------?-----------E-------?---------?--------o--
----------?-o----------------------------------------------------------------------E-----------o-------?----------------------------------o-----------?-----------E------?--------------E---------------
----------E---------------?----?-----------?---------?-------------------------------------------------------?-------------------?-------?---?---------------------E------------------------------------
---------?------------------------------?---------------E---------------------------?---E-------------------------E---------------------?-------------------E-------------------------------------------
--------------------------------------------------------E--?------??-E-------------E----E---------------------------------?---------E---------------------------------------E--------------------------v
-------------------------------------?--------------------------------------------------?-----?--------------?----?------------------o--------------o---------------------?----------------------------f
-----------o?-----------------------E?---------------------------------------------------------------?---------------------------------------------------E--------------------o-----------o------------f
---------E--------?-----------------?-------E----o----------E---------------------o-----------------?----E------E-------------------------------------------E-----o?E----------------------------------f
-------------?-------------------------------------------E---------o---------------------------------------oo------?-----E---------------------------------------------?----------E--------------------f
----E--------?------------------?----------o---?------------------------------------E----------?-----?---------------------o----------Eo--------------------------------------------------------?------f
-------------E-----------E-----------------------------------------E----------------E----------?----------o---------------------------------------------?----------?---------------------?--------?----f
m-------------------E----------------------|------------------|-----------------?---------X-------------X---X--------?----------------------------------?-?-E------------------?-----------------------X
XXXXXXXXXXXXXXXXXXXXXXXXXXXXXXXXXXXXXXXXXXXXXXXXXXXXXXXXXXXXXXXXXXXXXXXXXXXXXXXXXXXXXXXXXXXXXXXXXXXXXXXXXXXXXXXXXXXXXXXXXXXXXXXXXXXXXXXXXXXXXXXXXXXXXXXXXXXXXXXXXXXXXXXXXXXXXXXXXXXXXXXXXXXXXXXXXXXXXXXX
