--------------------------------------------------------------------------------------------------------------------------------------------------------------------------------------------------------
--------------------------------------------------------------------------------------------------------------------------------------------------------------------------------------------------------
--------------------------------------------------------------------------------------------------------------------------------------------------------------------------------------------------------
--------------------------------------------------------------------------------------------------------------------------------------------------------------------------------------------------------
--------------------------------------------------------------------------------------------------------------------------------------------------------------------------------------------------------
--------------------------------------------------------------------------------------------------------------------------------------------------------------------------------------------------------
--------------------------------------------------------------------------------------------------------------------------------------------------------------------------------------------------------
-------------------------------------------------------------------------------------------------------------------------------------------------------------------------------------------------------v
--------------------------------------------------------------------------------------------------------------------------------------------------------------------------------------------------------
--B-?--o-?--------o-MB?---------------E----B-E----M-Boo-E?-M-?----B---oB-----------?--M-B--E--M?----E----BBM----------M---EX--B----E---o----?---o?-?E---o-XXo--M---M-----------M??----o------------B----
--------B-E-------T--E----E-B------------TE-BB------?--?-M--E---M------o---M?--B--oE-o-?-E--------B?-EE---E-----T------M-E--XB----?--M-E-----?----BM---o--?X---?M?-o------------oM---??--oEB-ooE--?-B---
------------T---E-|---B-E--E-----ME---??-|----M----?M----M?------?-----EEoEEB--oMM----MM-----o---XMX-MB----T-o-M|---o----E-B-XX---B----B---M-E-M---MM-E--BX--------oT-----M--------o--M---B---T---B-T---
---T------o-|-B--M|-oTM?--E---T?-M?----T-|T-oMEE-E?-----------------E--?-?B-M---T-?----------E----XXE--BBT-|?E--|----M?------X--?--MB----?---B-TE-?--B---X---ET--M-T|-M-----oT-o--T-oB--E--E-T|?-E--|---
-TT|-TTT--o-|TMT--|-T|-T-----T|-T---T--|-||E--M---MBTo-oE-TTT-----TTT----TBTT---|TTTT-M-TETEX---XE-XXTo-T|-|-E--|TET-T-M-----EX---TET-B-T-T--TB|o-oBE-M-B-XToT|--T-||-T-T?T-T|---T|-TT-M-?-T-||?----|o--
m|||-|||----||-|--|-||-|-----||-|---|--|-||---XX----|-----|||-----|||----|-||---|||||--X|-|-X--X----X|--||-|----||-|-|--------X---|-|---|-|--|-|---X-----X-|-||--|-||-|-|-|-||---||-||-X---|-||-----|---
XXXXXXXXXXXXXXXXXXXXXXXXXXXXXXXXXXXXXXXXXXXXXXXXXXXXXXXXXXXXXXXXXXXXXXXXXXXXXXXXXXXXXXXXXXXXXXXXXXXXXXXXXXXXXXXXXXXXXXXXXXXXXXXXXXXXXXXXXXXXXXXXXXXXXXXXXXXXXXXXXXXXXXXXXXXXXXXXXXXXXXXXXXXXXXXXXXXXXXXX
