---------B---B----X---E------E-----------X--------------o--B---------E--?-------------------?----o--------o-----?------?-------M------M-------EX-------------o----M---B----oo--------------o---o--------
-B----X-----------------B---------M-----?----------------o----------?--?--------?-----------M----B----------------------MM---------------------------------oX----?E------B------o---------?----E--------
-------------X-E---X-----------?o---B-----o--------B------------------M--------o----o-----?B-----oM--------------------------------E-----------?X-E-----------------B---E-------E------------------E-E--
----------E------E-----o-XE-?--?-------MM-----------------B--------------------------E--------X----------E-----?-----------B------------EX----Xo--------M--------------------o---------?----X--M--ME----
--B-----o--------X--E------o-------oXE--------?----------X---------E----------X--X------M?--------B--------?o-----------------o--?---o---??----?--------X----?--E---Xo--B------------------------B----E-
----M-B---?----------------------------------B---o----------X-o---M-------?--------?---M-------B-B----o----B--M----??--B-o--------------------X--E-M---------B---X------Xo---E--------o---X-X-----------
---M-----?-----o-----E-B------o----------M------?E--X---M----X---?E-o-o-?-M-o-BX----?-----ME-X-----------M----M-B------------------?o------------B----E-?------E--------E------------B-?--o-------------
-----B-----o----X------M--------?----?-o---B-----E---B-----o--------X?B--------?---------E---------B----X-----------B-BM-------------o-EE------------M----B?o--o---E-------B--------------E--?---------v
-------------M--------?-----B-E----M---X--o----E------B-o----o----X----Bo-------o--------E---X---o----------?------M-------------------------------o-oM-------------M--MM------------------------------f
--o----------E?M--------------XoE----o---------Mo---------------M--o-----M--?-------------?E----E-------o---Xo-----?-E-------?-------B----M-----X-----X---X---o---------------E?--?--------------M-----f
---M-------X-X-----------M----E-B--M----?----X------------o--E-X-----o---X-X------o-------?----E?-----B---------B---------X-M-o---MX----E----X-----M---X----M-------o---M----M------B----M--B----------f
---------?--M-B------BX---------o--X--------o----------o---o--?X-----------?------------B--?-B-----?o----?-------?---o-------B---------E--XX-----B-----------M-?--M----E------E----o--M---X------------f
-X----X-----X----------------?o?-----E---------------------M-----------o-M--X-?--oo--?--------MM-----X------?--X----B--?--------M---------?------------M-M--M--E---------------------o?----ME--B----B--f
-----------?-----------E---?-------------?--M----E---?-M--?---??---M----------------B?-----------------E-------o----M-E-?-------o--------------M--------X---------X?---------X-----------------E-----BBf
m|---------------B--M---|----------------B-------E--oX-oM-------------|-----X----------o-------?-------X--M-----------------M----------M--?-M----E--------?----------|-------o----EX----|----------E--|X
XXXo?XXXXXXoXBXXEXXXXXXXXXBXXXXXXXXXXXXXXXXXEXXXXXXXXXXXX?XXXXX?XoXXXE-XXEXXXXXXXXXXXXXXXXX?XXXXXXXXXXXXXXXXXXXXXXXXXEX?BBXXXXXXXX?XXXXXXXXMXX-BoXoXXXXoEXXXXXXXoXEX-BXMXXXXXXXXXXoXXXXMXXXXXXXXXXB-XXXX
