T-XT---|-?X-o-?TM|-?|X--ET----M---M?-------B--E-M-X--X--|-B----T-X--B---E?--T--MT-E|----X-X--?----M--M----?------T-----?X-M---||TET-E-o--o-T-MXo-XX|--|-|?M--|M---------X--?---M--M--|--E-?-----X----BMM
MB---B----?---B-MoM-T----E?-M-B-o--o?B--E----?oM-|BETE-M--|-|--|X----T|o?--o-E--|X---E-------EoE--E--TBX-M-MX----?T-T---BoX-Bo---?------o-|-M----B-|---|M--|-To--|X-?-|T|--T----B-E-METT----o--o-o-E--oE
E-----?X?-|To--M-----T---X-----B------o-E-EB---|--B--T-??|-E|B---T--X--E|--?--?|E---M-E-M---T----Mo-XX--o-BB-TETXE------MXo-BB---?XT-B--|B---X------E?-Xo-oE----|M----B--BB|-M??-T----X--?T-XoXB----X--?
o|--BE-T--------------E-??--Xoo--B------X?EE--T--T-E-E----|--X-T-E---ME-?-M-M-T---T-----BE--?-B|?|X--E---EME?E--B|-X-|B-MXM--E?-B-TT|oM---?---TXXoT-B-M|MBXE?|-o--o--?---E-|-BB?-|?----B---X--XBM----M??
B?---ToET-?TX-----B---E--X-T|T-----oT--X|?--T|-|-T---|XB?Eo---|--T----MTEo|M-o---E-T--------?B-T--XoM--o?o--?T--TE------|---ME--MoX-E--?EX|M---E-M-B--?-oXXo-TMEE------MM-B-o---M-----ME----EE?|o-MB|--X
M---|o-EM--BX--oM?-----o-??--B?---?-------E--B--EM?--B--M----?Bo---M-|E--M---?-----M?|--E-Eo---Xo--|-E--M--XMEo-T|----X-?-TX-To-----M-?-?--|---|-?-E-oo---E--E-|B-EXXM----|-------o-------oToo-TE-?----X
oM--o--|||T-MXXX--M|-?---?--E-----TX-M-T-oE---E-------M-------B-----T?E?-||To--|-----TB--XM-?X-B|E-M---|M--?M?E?-B-------E-MT--|T-M?---ME-----o--XM--MTM-----o-X----T--X|o--X--M?-B---o-?ooo|-B|-oX--?EE
TT--oM-|oM---T---B-To-B--?BBE?|?------E---X-|MT--T-|o--?-B?-To|-BT--MM-T|----o-B-?---X---B----T-MTo--M-----B|M--o-B--?---X-B?MB----M--|-|-M-T--B|-M-oB----MXB-Mo-B-B-T--||----o-----X-oE----X---?--XM-Mv
X------X----M-----E--MM---B---T-|--?o----?XX---|T---?-B-M----M--B--oBo--?----o-X-Xo------MoTTE-|-X|B--BB-----T-T--Bo?---|?-T--T-o-M--X-X-|?-?o?---?---BB---oE--Eo-TXE|---XE--|--EM-M---oETEE--EXX----|BX
B--M----?--To-|X---?-o-T-M---X-X-M-M--M----XM-|--TE-----MT-E-oB-B---|-?MM-E-BM--Mo--X?---?|BB----?----o-T--------TX?oo--X---BM---B|--E-----?B---X-B-XoE--MM--TE-|---?----?|XE--B?--B--o-M--X-X-----??-BM
?-E-T---EX-X-TXX|?---X----B?-EM-|---|M??--oo-o--?X-?T-|o-------T---M-----BT---------?-X-B------oE--M-?--------oB--B?-?-MT-XE|E--E--------o-T---T--------TT-T|--oX-E-----B----TT-----M|-o-EXE-To-Eo-|-?X?
--?X-M--M||----?--?Eo--o-B-EBB-B---T-T-------E-X||----oE--ME-Mo-TEMBM------X---BoT---X--?X?---EEX--|-E?--?BET----?TBX-T-B-oXB---?-E?-E---?ET---|M--T----|EX----------MM--TX-X-----E--MMX-?--??M--o--?--B
|----EMM--E--------?----E--------E----M-o---XB-?--X-?M-TM-B|XT---EoTX----oM--MT-M---?---|?-B---|--T?E-?--B-T---M---E-?---Eo-EM-||------M-|?-E|T-|BME-T-----?-E--E--M-M-------o---MBB-BX--B---M--XM-o??o?
|--EBM--X----EB-X--?-o--M-M----|?----T-oo-o--ToEM-E--ME--T--E--E--X-T----o--B-B--M--MBTB-|--M----BBE-?-----|-X--|-T-|--E--EM-M--ME-ToE-MM---Xo--M--E--??B?M??T-X?-o----o?E?MX--X-|-?--o----MBXX-Xo-|?ooM
m|E-E--To?-BTEM-X---o?-X-X--|-T---|o--|-|--BBX--X-B-B?-X-B--T|---B-|-oB-|-M---M-ToT?---------o----BMoB-------o-T---o--E-E-o--o-----B|XTT-?MTEXEB----o-----|-T--?----B-----oo----Bo---o|X?----X|MX-MT|o?X
XXXXXXXXXXXXXXXXXXXXXXXXXXXXXXXXXXXXXXXXXXXXXXXXXXXXXXXXXXXXXXXXXXXXXXXXXXXXXXXXXXXXXXXXXXXXXXXXXXXXXXXXXXXXXXXXXXXXXXXXXXXXXXXXXXXXXXXXXXXXXXXXXXXXXXXXXXXXXXXXXXXXXXXXXXXXXXXXXXXXXXXXXXXXXXXXXXXXXXXX
