--------------------------------------------------------------------------------------------------------------------------------------------------------------------------------------------------------
-------B----------------------------------------E-E-o-------------?-----E------------------------E---------?---?---------o------E-?--------------M---------------------M-o---------B---------M----------
-----------------------------------------------------E---M-------------------M---o---oM-------------------B-----------------------------E---------------------------------------------------------------
----------------E-?-----------------E--------------M-------------------------------M-----?oE------------B-M---------E------------------------------------?------o------------M--------------------------
-------o--M----M--------------oo-----------o------------------M-----------------------------------?-------------------M--?--------------------?---------------------------E------B----------------------
-------?--?-----------------------------------B--E-M------------------B-----------------------------------------ME--B-----------------B---------------------------B-----B------------------?------------
------o-------------------------------M------B----------------------------------------M---E---?--B--------------------B-----M--?------------------------o----o----M--------------------------B----------
-----?------------------------------------------?------o------M--E-----------?--------------M----------?-----------------?-----------o------------B------------------?--M------------------------------v
--------o------M------?--------?------------o-?----E-------------------B-------M-M-?----------------------------------------------?----------------B-------------B---B---------------E------------------
---E-----B-B?---?o-B-B----MM-------B--ME-BE----M-----MB---o---MMEE-o--E-?E-EE---------EEME----?-----Bo-------oM-----BE--o---?-------o-E-B--B--BB--BMo---oM--ME-o-----E-------M-----------B-BB-----------
--E--?---MB-EM--?--o---?-o??-----X?-B--?------?-E------------E-?--?---E-o-|----?M-----o---E-----B?o-oo-MM--B-------oE--B--o---Mo-ME---B----o--?M---?--?-----o------M?------------Eo--MM-o---------------
-----ET-----E-?XM-E------M----o-B-X--E-----oo--E-----------?B--------B?---|-|-?----E--EEo-----E---E------o---E----MMB--o----------?o-?--?-X----o----?-------XX----?-----BEo---B--E---X---E-B------------
-----E|----B--X-XM-----E-------XB|MXX?---E-BE-E--E-------M-|-?M---ET--oE--|-|-M-X?----?-?---o?-?----------ET-?----EX----oTEMT--B--E----o--X---o-----EE--X--?-XX-M-oM-oB--E---BE-|--?X----o-M------------
-?-T-T|--Eo-E--XEETE-TT---M-----T|-X-----TM--E-TETX-------T|-X---TM|To----|-|-|-TXXoX|-E--|--|------TTEXTB?||-TT-o--X-oT-|--TTT-XX-M---X-o?---ET?T-T---X-----XXTX-MT-T-TT--B-T--|-T--X-X--|M-|----------
m--|-||--X--EoX|--|-X||-----B-X-||-X-B---|--|--|-|-X|-B||-||--XXM|-|||-XX-|-|-|-|-BX|||-Xo|--|--X-|-X|-X||-||-||---|-XX|-|--|||-X-XXXX-|--XBB--|-|-|---|-|--XX-|BX-|-|-||-X-X|--|B|-X-X|-M|BX|----------
XXXXXXXXXXXXXXXXXXXXXXXXXXXXXXXXXXXXXXXXXXXXXXXXXXXXXXXXXXXXXXXXXXXXXXXXXXXXXXXXXXXXXXXXXXXXXXXXXXXXXXXXXXXXXXXXXXXXXXXXXXXXXXXXXXXXXXXXXXXXXXXXXXXXXXXXXXXXXXXXXXXXXXXXXXXXXXXXXXXXXXXXXXXXXXXXXXXXXXXX
