-??------------------------------?-------------------------------------------------------------------?-------------?----------------------------------------------------------------?------?------?-----
------------------o---------o-------------------o-------E-------------------------------------------------o----o----------------------------------E------------------------------------------E----------
-----------------------?-------------------o--??---------?-------------o-------------------------?--o--?--?----------o----E-----E---------------?-o--------------------?--------------------------------
----------?---------------------------o-----------------------------------?-----------------------------E------------------------------------?----o--------------------------------------------?--------
---?---------------------------------------------------------E--------------------------------------------------?-?--------------?------------------?---------------------------------------------------
-?----------------o-------?----------------?---------?----------------------------------------------------E------------?------------------?---??---------------------------------??---------------------
------------E----------------------?----?---------------------------------------------------?----------E---------------------------------------?----------------------------------------o---------------
------------------------------------------?-------------E--?-------?---------?--------------------------------------?---------------------------------------------------------o-------------?----------v
-------------------------------------?-----------------------------------------------?----------------------?------?-----------------------------------------------------------E-----------------------f
------o?--------E-------------------E?--------------------------------?---------o---------------E----------------------------?------?---?--------?---------------------------?----o--------------------f
--------?--------------------E-------------------o--------?-E--------------------------?----------------------?----------------??-----------------o-------------------------------------------E-?--?---f
---E----------------------------o--------E----------------------------------o------------E------?----E--------------------------------?----------------------------?-----------------------------------f
--------------?-----------------??---------o--------------------------------E----------------------------------?-----------------------o----------------------------E---------------------??-----------f
--?------------------------------------------------------------------------------?----?--?---------------?----?-------------------------------------------------------------?--------------------------f
mE---------|--------E----------------------?-----------------------------------X-?--------------------------|---------------------------------E--------------E---------------------?--------X---------EX
XXXXXXXXXXXXXXXXXXXXXXXXXXXXXXXXXXXXXXXXXXXXXXXXXXXXXXXXXXXXXXXXXXXXXXXXXXXXXXXXXXXXXXXXXXXXXXXXXXXXXXXXXXXXXXXXXXXXXXXXXXXXXXXXXXXXXXXXXXXXXXXXXXXXXXXXXXXXXXXXXXXXXXXXXXXXXXXXXXXXXXXXXXXXXXXXXXXXXXXX
