o??----T-o---|T?EXo-?-o--|M-M--?-|XM--o?o-TBXETBoM-E-M-ooTT--oB-?--oXB?o-X--B-Xo----BEo?-|oB----o--o-ME--T?oBX|-E---oXEEE|-B-E-B-XM-|-E-MMTEE?-oX------TM---oM|B|E|o-|M-?-M-----o-o--o----o--oEMoE||-M-M
E-T--?-B--MB-E---oX-X-M-TMB--?M---??-M-T--|TX---o-BB|--B-X-M---o--|----?|--o|--o?-MTBoX--?|o--EBM|-EXB--?T-|-M-B?-?---M--ET-|XX-o-X-oo-TT--BT--o----MM-T----oB--o-o-----M?-?Eo-T--XMB---?XT--E----T----E
--?---------EX-BE?TX?-?-?o-TM-TXT|M??-T?T-o-oM?o---o--|M-|o?B--E---o|-XoT--||oBM--XET--TE-EM-----?-XX-E----M-----MX-TX-oE------M|--o--X-MXXMT--|-?-TM|?-?X--oMXB-TM?o--?-XXo|M|Eo-XBT------B--BTo|BT-XTo
TM-|ME?o|B-?-T---?-M-B--?X---M?-EMBETBX--E-?T--E|TT|-BB--T|---oB-X-?EME-B--|B-ET--B----T-oX-----M-EM----?o|?-----T?-TE-ETEE---?B-Xo-|?----|----|XMX--ETEo??-E-T-X?|M?BT--TXXE---o|X??XT-?---?-BB-|-?B|B?
B|MEXE?oE-B-?o?BM|--XT-MXo-T|E-X-|oB-?-EE|MME--MT-|--??E?E?T|Bo|--EXB?-??-----B---B--T?-----|--B----MB-TX|-?oEM?--BBB-BTE-M-|M|BB-ET--M-ToMoT----X--|-T?--M---|--|M--T---X---E--B|oB|-M--X--XM?X---Mo--|
XoTE----XBX?o---T--B-|ToT-B--X-?X||TEB-XM-XXB-EME--E|E---X--T-o-TTM?E--B--Eo-o--ETMEE-B-----oTMB-o-X-|-?T-XB-Bo--B|--X-To-T-Bo-MXo----B?BET---X?XB--MMoXEX--E--M-T--E---|-|B-M---oT|o-X--oXMT----XXooMTE
B|-o?-Xo|M-o---E-XX|M----E?--?BT---EM?MXB|M?-EXM---o--XM|MMo--M?-T?--?-?E--X-B---|T-X---M|o|?B|--oMM-E-M?B-M|--?---T||T--|TooETT-X--E|-----?--BX|---o-?-T-T-|MX-|T-MB-B-E--|---?-o---|-EBB-To-?---BT?BE?
B--|--?-B-T---X-T----MTBBX----EETo?B-?-|EXT?oT--M--|BX--EB-M--XM------T|oo-o-X-?-MXX-ETM|-TXoMT-B-?-BTE-X---|XX--TB--E--T-----T--E-T----T-X-|M-M--ET|X---o--|-M--||M---XB---E--o-X|T|---X---|---MX---?-v
-BoToM--|XX--T-B-|M---Xo-X---|--o-M-oo?----B-TTMM-oBMBBBXo-T?-T------B?-T|M------XXM--o----o---E-B--B?T-|---ET|||M-EEE-?--|-----?B-E-XE-|??o?BM-|-B-TE--|----o-E--o-------T--T-BMo----?E-T?M?E----MEB--|
o--ET-X-X-X?E|-o---|-T----o--BXo-|-oMo---MEo|?-?--EE--B||--T----E-T-M?-EoXBE--|--oB|X-EEB|----T?B-oo-o|----B|E-oX--?|--XEMEM?oMBoo---X--TXo?BT--MEXoET---|TEBX---T-o-X-M----T--MEM|-T-X-||-oBM--TX--?--T
-T-?-ME---Eo-M--BoE-?|-?--T-?oT----E?-----M--Xo?ooBo?|E--T--|-M?B--M-B-o--|E----?--ToE-E--E?--EBT-E--MBMX?B---X?--TBo---oTM--MTB-E-MX--Mo-|---EB-|-X|-X-BTo--?---------E-|TB-?oXMM---X---Bo--EMT-M|o-BE|
?---EoMBB-?---T--X|-?-B|-----o|-TE-XX--EBM-X-?---?M-BM|-B--o-XX||||MEEoXE-?o?||oTTB---B?E-X-?-M-X-?----oX-TBo-oM?E-EM|---BM--B-|--?--B-BBMEE--|-TXoE|--ETT|--X-MM--o?-?T-X|MTo|-X|-|Bo-oE-?BEX??o-X-?BoT
X|-|BE-oXT--E-|o-oM|XTE?-|--|---oB-B?Mo---?ME?B--|---E-|?TTT-?MT--T-o-M---|-?M-?M--TMT|-o?ET--?-|-?-M--B-?TTE|-B-X-T-XEM-X|---E-|T-E-o-X-Xo-B-X--oE-|X--|o|?-?--EE-|-B---oT-T-----oM|-XE?-X--T?XX|-|?-Mo
|--T-XB?----EE-ME----T--M?--ToXo--o--X?-?--Xo--X?-oo--BE----oo------oMM-EE-X-T-BX-o-B-T-oB-??XEE----M?T--T|T-|oE-E-M---EoBo--X|?E--o-?-oT-?B-oBX-Mo|X-||-o--Xo|-XT--BMB-MM----|T-B|MMX-o--T--|TBEE-MT-|X
m--o-|---X|-X-X--EX-?-MT-?o-?--?T---oT?MM-M-X-------EE-BMBM--EEo--?----B-X?o--B|B---|M-ME-?|E-M---M------oBT|X|BXBE---X---XX---M---B?BXTXM--EMT-o?--?T-X?-|-EE?-Moo?E-----|M--|X?--B--oo-|-X??--o-E----X
XXXXXXXXXXXXXXXXXXXXXXXXXXXXXXXXXXXXXXXXXXXXXXXXXXXXXXXXXXXXXXXXXXXXXXXXXXXXXXXXXXXXXXXXXXXXXXXXXXXXXXXXXXXXXXXXXXXXXXXXXXXXXXXXXXXXXXXXXXXXXXXXXXXXXXXXXXXXXXXXXXXXXXXXXXXXXXXXXXXXXXXXXXXXXXXXXXXXXXXX
