--------------------------------------------------------------------------------------------------------------------------------------------------------------------------------------------------------
---------------------------------------------------E----------------------------------M--------------------------------------------------------------E------------------E----?--------------------------
-------------------------------------------------------E----------MM-----------B--------------------------------------------------oM-E------M----------------?---------------o-----B----E---------------
---------E----------------------E------------M-------B-----------------------?----------------------------------------------------------?-----------------------------E--------------------E-B-------o--
-----------?-------B--------------------------------o-------------------B-o-----------------------M--?---------------------------------E-------M------------o------------------------------E--M---------
--------?----M----------B---------E---------------------o-----?-------E-M---------------------M-----------------------------------------------------------o----E--B?------------------------------------
---------------------------------------------------------------------------------B----------BB-------------B------------?-------M------------------------?------------------------?---------------------
------E------------------M----------E----------------------M------------------------------------------M----------------------------------------B--M----------------------------------------------------v
----------------------------------M----------------------E-------------BM--------o--------E--------?-------------------E--B----------------------o--o---------------------------------------------------
-----MM--E---?----XXoXo--?EE----M-o--M--?----EoB-BoB--XX--B-o---B---------B------?-XX------------o---o-oo-?-Eo--oo--MEMM----E?B--------?o??--------EM--E--B--------X-o-----E-o----Mo--oB-------BoB------
---?--B-E-E--EE--MXoX----B-?--M-----M-----M--ME?----E-XB--?-o--E--M-o----o-----M---XMX--BE-X---B-XXE-?BX-------?B--o---E------E--?----o--------?MM--------M--?M----oX---EB---B-o--o------------o--------
-M----o----E--E--?-XE----E-E---B?-----------M------B--XoX-M--E------B--B-E----o-----X?E----Xo---XXo?-M-X-?o----E-E------o---?-?M----B----?-B-o----------B---E---MEM-X-X-o---?-------M-------------?-----
-EoM---B-?-?------?-X------E?----E-o---M--------M----MXX--BXE---M-?-M--B-?----------??EE----Xo---Xo---o-XX--E---?---?-----o-oB-Boo----M-----BE----E---o?---E----B-o-?XBX-E---BM--?---X------?---o-E-B---
--?M----EB-oE--Eo--X------B-------XM------BB-X-X?-B-B-XXX?-XX-?--E?--M-B----------o-X-B-----X-----X--E--XE-?----?-?--E---M-EMX--oM----X--EE----o--?--XXE-M----X-oXBXo-X--T?X--X--o---X---B-X---E---MXX--
m-----o-o?B-E-----?oX-?X----X|X?X-X---X-XXoMEX-XBX-?-X--X-XX?--B-XE-BX-M-E---?E--MEXXo--B----X---XX-X-M-X--M?------M--MX--EX--X-X----XXEX--M?--BXBEo-XX-----XEX--XX---X-B|--X-XXEo-oBBX---------XB-BXX--
XXXXXXXXXXXXXXXXXXXXXXXXXXXXXXXXXXXXXXXXXXXXXXXXXXXXXXXXXXXXXXXXXXXXXXXXXXXXXXXXXXXXXXXXXXXXXXXXXXXXXXXXXXXXXXXXXXXXXXXXXXXXXXXXXXXXXXXXXXXXXXXXXXXXXXXXXXXXXXXXXXXXXXXXXXXXXXXXXXXXXXXXXXXXXXXXXXXXXXXX
