-?---------o-?--------?------------------?---------o---------------------o--E----------o--?-------??-------------------E-------?--?-------------o--------o----------------Eo------------------?-o-------
----------------o?--E-------?-?------------------------------------------E--------?------?---------E----------?--------------?--------------E-----------E------------?---------------E-------o-------o--
---------E------------?----------------------?----------------------------------E-?---------------------------------------------------------o------o----?---Eo-----?-------------------------E-oE----?--
---?-----?----oo-----?--------------?--------------------------?-o---??-----------E------------------------------------o-------?-----?------?------------------------?-------o-??------?E---------------
-----------------------?----------------?---?--E------------------?-----oo-------------?-------?-----?------------?--?--?----------------------?--o---E------E---------------------------?---o-------o--
------E----------o-----?---------E----------------?---------?------?-------E---------?---------?------------------?---o--------------------o--------------?oo----E--------------------------------?-?---
------E----o---------------o---??------------?-----------------------?------E-------E-o-----?------------------o---------?--?E---------------?------------E------------------?-------------------?------
-------?--------o-----E-----------------?---------------o------o---?--E----------------?-----E---?---?-------------------------?----------------?--------------o-?------------------?------E--?--------v
----?E---------?---?-----E---------------------------o--------------------?-----------?-------o--------------o---------?-----------o--------------?-----o-------------------------------??--o----?-----f
--------?----------------o---------------E--------------------------------E-----------------------o-------?-----?---------?----------------------?-o------------o----------?------?-o------E-----------f
---?--o-------------?------------------------------------------o-------?------------?--?---------E-----oE-?-----------------------------------------E---?--?--?-----------------?-------------------o-Ef
-----?------------------o-E-----------??--o-------------?-------o?----o--?-----?----?------------------------E----------------------------------o-----------E-------?--o---?-----------------?---------f
-E--E-?-E?----?-----------------?---------------------------------------------------------------------E?---------E-----o-?----?--------?------o--------------?-------?------?-----------------------?--f
---|-----------------------o|---------------------------------?----------------E-------------?o-----------E---E-?----?------------o----|--|---E----------------------E-----?---|------oo-?---?---------f
m--|||---|------|--|-E-?-|-||----|-|---|?--|--|----|---------|oo---|-|---?-|----?----|---E|------|-|---||-------?----------|-----|---|-||?||--|---------------|--------------|-|---------?----|----|---X
XXXXXXXXXXXXXXXXXXXXXXXXXXXXXXXXXXXXXXXXXXXXXXXXXXXXXXXXXXXXXXXXXXXXXXXXXXXXXXXXXXXXXXXXXXXXXXXXXXXXXXXXXXXXXXXXXXXXXXXXXXXXXXXXXXXXXXXXXXXXXXXXXXXXXXXXXXXXXXXXXXXXXXXXXXXXXXXXXXXXXXXXXXXXXXXXXXXXXXXX
