--M---T-EBB-oMBTBoBBo--XX------X----oET--|--E----oTXMM-?MXTM-||M-?M-?--X|----M-XB?o---B-Mo----?-?-|-o|-B-?-Xo-?--|---XM-----|-o-X-E-?T-MBT-XX--XXB--TMX--MM?-B|-|M|--oo?-Bo-BBBo-EX-?EoB-E-M?X-E?X--ME--
-|--M-|-?XX-oTX----|-M-T-?--|--E--T--||--T--X-X---B-oB?B?M-TE-|X------|-?ME|-MBX-|MB-B-|MoBM|oX-----ME-BoT-XBoT--X----|X-|MoMXo|-----oT--|-B?--EX-EXT|-----BEEo--M-XEMB--|TB-M--TT-|--|BBBMBB---T-?|E-E-
----|--M-|--X?T--TE---EXB--B|--o-TEoEBBEE-||EX--TXE-XBX--E--?T--E--|--o?EETB--BoT--E--B--o?oMTo-ET-------M?--E?MM--MB-|o|--|---oXX---MTB-Xo-o|?-E--XTXB-TX|o-B-oo--XBT--XM-T-B---E|E-T--?--?E-|-oETX-o--
---?--|-T-XM--TX-oE-o-|-|??Bo?E-E---X-M|?MXo-o-oMToE-EE-XM-TT?---o-?--B--T?-E-T-----|-E|------T--BM-X-|-oXET----?BT-oo-MEBMEo-T-E---M-BX?-B-|-B-X---T|oX?--|-?E--MoT---BTEETT-B--?-BoT-Mo----TT---M|?EX-
-o--X---E---o---B-|T?B|BX-|-o--oEME-?M-MT|---oT-o|E---M---|o--E-oM-EEoBX-o-|--||X|X--XEEEoo|--XB-B--TET-XT-MM-MBooB-E-T?-|-----E---o--BMo-M--TET-oX----|--T-oT----E-M?-X-TE-MB-|?--T--E-TE?T?T-M---E-TB-
-T-TTBo---B--X-T-|T-oM--|-?Xo-o-----|T-EB-MX--EoT--|-----?oo-M-TE-|?--B-TT----|-EX--M-|?Xo--E-M-B-X--|-M--o---BT-E-T-X?E----?-----E|-|-MMoE-TM-MT|To--X-T|o---B-TB---?-o--oBT?---T-?---B---M-|-M--o|----
-|-To--M-|XXoMMM?-o-o-X|?Bo---MT?-TB-?|-XET-E-oT-|-M---M|-o?-||-|-B-oB?--E---EXE--T----T?TX|--B-oXTTTo-BE?-T-BTT|XB|o-|?M--M----XoXME?-BT-E-----oT-E---B--|-B-|---BT--XM-?|oB?-XX--||o??--XTT-o----E??--
-XE-|EX-B|E?--Eo-M---?E--oM|X-X----o-E-?BE-?|MT-E-|-ooMB|?--EM-Mo?M-Xoo?M-o-X-B--?E-o?B-B?---|---X--BoB-?--XM----T---?M|--|M--o--Eo-?B--o-M-||T-XX--MX--Xo?--||-XE---B--T---|E-----B-X|E-MX---M-EE-Eo--v
-?oBEB-?E-B-X----?--|T--BMTM-?-TM-o-M-X--ToT-|--|-EEo-----XX-TMEX?----EB-?Eo-B---?|T-BoB--TE-?----B--TTB--M---T|oT-|T?--E-MB-|-T--o-B-o|-XT--?-?TXM|EEE-X|-|o--BMX--M--BBX-BT---B?-|---EMM-|BX--oBoM--Ef
-T|-E|-MT--M-B----|--o-oXT--BT|-Xoo-BB?--TM----X?-B----E|-XT---X---o--M-B-oT-|-E-T|---EET-E--To?-|o---M-o--E-?-T-??--o?M|----T?--E--X----|T---XXTo--?MTT--X---MM-E?XEM----o?-?T----E---B---X-EEX|----oof
--oX--|--oEBTB-oXETBBEE--T--M-o|BBXMX-Eo|E------M-o--T-o-T--o--X?|-?---|To-T---?-BTM-B-ET|MT---M--|--?X|E-BME|XM?MB|-T-M---M---|B----T?T|-B-|-?-o---?||ME?o-T-?EB-EE--|||-|o?XoM-|B---X----B-B-o-?-?X|-f
---oT-TMB-----?ME--?o??o-?-?-EM-o-Eo?BBB--|TX?XTBBo-T--MBE---TT-T|--Bo-||M-E-|-X-B---oT-BMM?-X-E-o-ETE-B-M||M|-o--BBTT-ET--M|-|o-B-------M|-B-TMBE-|T-XE-TE--?o?---o-X|-o-o---M--oMo--XBMX-BE-o-oBo---Tf
-E-B-oE-|--oM-XB?--oXBT|oT|--X-|EMXT-o-E--T-o-E|T-T?--E?MEBE-T?-XT-o-----M-?----TXEEoo-oEB|X-----oTX--ToX-M-X-T-T---B---|-M--E-XM|---METX--BoEo-M|--BX?EMX-ME|--|?--XTM-MoE--B--B-BEMBTEE-M---E-X-E-T--f
--XMB---o--TE-?M|oB---|E-M-?-MXT?-T?--ME|BBE-X---M|TMBBT--T??--MX|-oT---|?-B--|T--M-E-B--X-|To--E-T-B-oXEX|?-MX--E-M--oX-o-----?-oT---EEB-M?-----X?|o-XXE|o-?-|?----XM--X??E|MB-?----o-M-E-BXoEBo-o--XBf
m-BXTXoE--X-E|B----|-MX?E|M-BX|-X-X---MX|M-oB-o|-E|?-?--M|--T-XEEoMTB-B?--|BM----E-MoM---E----o-|-oo-XXX------E?X--o--|-o-E--T-?E-|MX|oooo-ME-T-?--BT-oX-T---TE--XoX-|-B-T-o--B-----X-??E--o--o?oo?EE-TX
XXXXXXXXXXXXXXXXXXXXXXXXXXXXXXXXXXXXXXXXXXXXXXXXXXXXXXXXXXXXXXXXXXXXXXXXXXXXXXXXXXXXXXXXXXXXXXXXXXXXXXXXXXXXXXXXXXXXXXXXXXXXXXXXXXXXXXXXXXXXXXXXXXXXXXXXXXXXXXXXXXXXXXXXXXXXXXXXXXXXXXXXXXXXXXXXXXXXXXXX
