----------E------------------E-----------------------------?----------------o--------------------------------o-----?----------------------------?-----------------------------------?-------------------
--------?-------------------------------------------?----------------------------?-----------------E------o----o-----------------------?----------E----------------------------?-------------E----------
---------------------------------------------------------------------?--------------E---------------o--?----------?-------E-----E-----------------------------------E-----------------------------------
-------------------------------------------------?---------------------------------------o-----?-----------------------------------------------------------------------------------------------?--------
----------------------------------------------------------------------------------------------------------------------------------------------------?---------------------------------------------------
--o--------E----------------------------------------?------------------o----------------------------------E------------?------------------?---??---------------------------------??---------------------
---?------E----?--------?---------?--E----E---------------?----?----------------------------?--------------------------------------------------?----------------------------------------o---------------
---------------------------------------------oE--------------------------------?o-----------------------E-----------?---------------------------------------------------------o------------------------v
-----o----------------------------------------------------------E----?------------------?-------------------?------?------------------------------------------?----------------E-----------------------f
---E--------------------------------------------------?-----------------oE----o-----------------E----------------------------?------?---?--------?------------------E--------?----o--------------------f
-----------?--------------?-------------------------------------------------------------------?---------------?----------------??-o---------------------------------------------------E---------?--?---f
---------------------------------------------------------E--------------?--?--------------------?-------------------------------------?----------------------------?-----------------------------------f
--------------------------------------------------------?-?-------------------------------------------------------------?-------?------o--------------------------o-E---------------------??-----------f
------------------------------E------------------------E-------E--------------o-------?-------o-----------------------------------------------------------------------------?--------------------------f
m------------?---------X---X----------|--------------|----|-----X-----------------------?o------------------|-------|------------------------?---------------E---------------------?------EXX---------EX
XXXXXXXXXXXXXXXXXXXXXXXXXXXXXXXXXXXXXXXXXXXXXXXXXXXXXXXXXXXXXXXXXXXXXXXXXXXXXXXXXXXXXXXXXXXXXXXXXXXXXXXXXXXXXXXXXXXXXXXXXXXXXXXXXXXXXXXXXXXXXXXXXXXXXXXXXXXXXXXXXXXXXXXXXXXXXXXXXXXXXXXXXXXXXXXXXXXXXXXX
