--------------------------------------------------------------------------------------------------------------------------------------------------------------------------------------------------------
--------E-----------------------------------------------o--------------------------------------------------E-o------------?------------------------------------E----?-----------B-----------------------
-----E---------------o------------------------------------------------------------E-----------------?--------------------------------------------------M-------M---------------------E------------o-----
-----------------------------------------M----------------------------------------------------B------o-----------------------------------?-----------------BM-?--------M--------------------------------
----?---?---------------------------------------------B-------------------?--------------------------------------------------------B-------------M-o---------E------------------------------------------
------------E------------------------o---------B----------------------------------------------------E----------------------------M--------------------------M---------------------o---------------------
---?--------------------------o------------------------M-------------------------------B-----M----------B---------------o-----------------?-----------B-----------------------------E-------------------
-----------X-----E-----------------------B-------------------------------------?------------M------------------------?-------------------------------------------------------------------------?-M-----v
----------X?--?X---B---X----------X-------------------M---------------------E------o------------------XM-------------------------X--------------------M----------X------?-------------------------------
----X----X---Xo-XE-----XX-EXo----EXXoXXM----?X--X-XBE-------XXo--M---?--------------?----?---X-X------XX--?-XX-XXX?-XX?X-XX--?-?X-E--X-XXX---E-?XX-?-?X-M----X-?X?----?-----?--?-----XXXXX-XX-XE-XXX----
-----XX-X-----XXE--E--oX?EXX--------XXX--E-??-XoX-?XX-E-??-X-XB--???-?--E-??----------o---E-E-X---?X??X-----EX?XXXo-XMXBoXX--XXX--EX-X-?X-----?X-X-X-?X---E-X--?XXX--E----?--o-?------X-EXXX-X?XE-MX-o--
-oXXX?X?X--?E-X?--o--oX-EX--X----??oX?X-XXXXEXMX?XEX----?oXoX?E---??-Eo?---XXo---XoXoo-X--Bo--XE---XXX-EX--EXXXX?X--XXXXXX?---X----X-X-MXo-oE-?XXX--X-X----X-o-?XX-?--E--?o---------oX?XX??X-XXXXX-XX---
--?XX-XX-B-X-o-XXX-?--?X-X-X-EEoo?XXXX-XXX-X-X--XX-?X-X-XX?X--o--o-o---XXX-XXo-X--XX-?EX-X?-?o-XXXBX-EXX-XXXXXXXoX-?-XX?-XX---X-E-EXXX?oX?-X-?--X-X?-X?---X---?---XXX-oE----------?-oX-XE?XXoXXXX-XEXX--
---X-XX--EX--?-EX---?---X-X--?X-XXXXX?X?XX-oX--XX?X-XXXX-?X?--??-----X--X---XXXX---X-XX--Xo---XX-X?EXXX-?-XXoXXEXX-X-XoEXX-??XEXXEXXX-XXX-XXo-EoX-XXX--XX--X-Xo--XXEX----E--?E-E?o-X-EXXX?-XBX--oXX-EX--
m-XXXBX-?XXXX-X?X--EE?-?oXX-XXXXX?XEXXX?X-X|XXEXXXXE-X-?X?X?--?-oE?XEX-X--E-XXXXX-EoXX?XXXXEB-?X-?XXXEX--?-X-XXEXXoXXE-E-XX-oX-oX-X-XE-XXXXXo-?X--XXXo-XXXXX?X----XX-X?X?Eo-XX-X-X---XXX-BEXX?XXXX-X-X--
XXXXXXXXXXXXXXXXXXXXXXXXXXXXXXXXXXXXXXXXXXXXXXXXXXXXXXXXXXXXXXXXXXXXXXXXXXXXXXXXXXXXXXXXXXXXXXXXXXXXXXXXXXXXXXXXXXXXXXXXXXXXXXXXXXXXXXXXXXXXXXXXXXXXXXXXXXXXXXXXXXXXXXXXXXXXXXXXXXXXXXXXXXXXXXXXXXXXXXXX
