--------B---------------o----------B-------E-M--E------o---B-----E----o-M-----oE--B-------o--M-E----?---------o----------E------M?-------E-------o--Eo--E-B----------------M-o----M-----o---oEoB--------
---E-----?-BE------BB--o------E------------------?--B------o---?------BE------o-----B---E---?-----------------?----o-----------------?----?E-----M-?-----?-o--oE--------------E-M-?-o---o-?---B----B----
---------------M-----E--------M--------B------B--M---oE---B-----Eo--BM--------E------o----B-----?---M----------?----------o------------------------E--o---?----B--E--------B------------?-M-------E-----
-------B-------o-E---------BB-----M--?--ME------------?-B-------------------M-?B--o----------B----?----------------------EM---------o------o?--------------?----------------o--B-------------------E----
-------B-----E--B?-M------M-o------M----o--o--M--M--M---??---?------B----------E-------ME---EE?Mo----------B-----------B---E-M----o---o--------MM----------?---Eo----o---B-E--?--------B-?-B---------M--
--B----------------o--?-------B-----??--M------?-----B--------B--o-----MM--B-------Bo------------E--B---?M---M------M---------B-B?-EBo--M--------B---?--------E--------B-------B-o-B-----------------M--
---E--------oM-B----?------------o-----E------?---?---------B--B-----------------?------------BB------B--?---E-------------B-o-o-----B------------B-------------B----ME----?M--E----?-----??----------M-
-----B---------?E--------o?E--o-?----------M---E--E-----B----?B-B-M---------B--M-E-?---------o--E--o?--?-----M?---------B-------M--o---Mo-------------B-o--------o---------------B---E--------M?-------v
-?---MM------?---o---?-----o-?-------M--------------M---------Bo?---??-E---------M--MB---M-?----?--o-------E--B---E-----o---?-----------EB------M------------BM--o-------o-?--------E---o--o-----------f
------------?-B------E---------------------B---B-------------oEE-E--------M-----------------?B---?-o--MM----E-----?----------------------------------------BB-------M------?-B------------B--B---?--M??f
-----ME--E-MBo---M-BM---o-E---B-------E-E-----E---?E------------?-----M--o--------M----?-o-?------E--E-------o?--------oE---------------?--------o----M---?E-?---?---------------Bo------?E----o-E-----f
-----oB-Eo-------B---o----o---------------?------B-----M--o--------?-----o?--M--B-o----------------M-----------------------B---------------BE--?------------------oo--B?E------B?--B-----BE----B---E-o-f
-----BM---o---M----B--?----o----E--?B--B------oE-M----E-----------------M-----B-M-o?---------EB---------------?-o--E--------M-o--------?---B---MBE-o?-------o----------o--M------?-M--?----o----E?-----f
------------MM---EE-----------M----oE---E---o--------B--E--------o------B--E------M-----------o-o------B----BEE--MM----M--EM-M-----------?-o---o------M------MB----B-M-o----E-B-?---------E--o---------f
m---|-----oE----------X---X?-----------E---|--EM---E----M----------------o-X-|-------------X-E------X|-------B-----?---------X------Mo---B----?--------?M-o--o-M-----------M-----M-X?---M-----B-------|X
XXXXXXXXXXXXXXXXXXXXXXXXXXXXXXXXXXXXXXXXXXXXXXXXXXXXXXXXXXXXXXXXXXXXXXXXXXXXXXXXXXXXXXXXXXXXXXXXXXXXXXXXXXXXXXXXXXXXXXXXXXXXXXXXXXXXXXXXXXXXXXXXXXXXXXXXXXXXXXXXXXXXXXXXXXXXXXXXXXXXXXXXXXXXXXXXXXXXXXXX
