--M-BB-------------M-------M---o------------------M------E--------?----o-----?--?M-??E------M------?-BE?---B--M----o-o--B------?-oEE-?----B-----------o-------B---B--B--B-M--M---------E----------------
-----E--M-M------E?----------E-------?---------M-------E-------?--B----------o---o-------?-----------MB----o--B-o-E-B--B------E--------------------------ME----B-?----------------------------o---?-----
-B-o----B?E-E--Eo?o------?---------E------o-E--------BE-M-------------E-----o----------o---------o----?-M-o--B---------------E----B--------M-?B----o--B?----o?-o---o-----?--B---B-----------------------
--E-----?-----?--o---?--M-o-E----?---?----?---?------o--------o----------?---?M------------M-EB------?-B--M---?--------------E--B-------Mo---E-----E-----?-M----E----o--o-?------?------------------o-o-
------------B----?E--EMo----?----M-?E-E----------o--o--?---------B?----B----B---------o-M-----------------?---E-------B---B---M-E---?-E----oo------M----------------Bo--B--EB----o--M--E-----o--M-------
-Bo--M----E-ME--------?-----o-?--------ooB--?---B-----------oE-?---o---?----E--o-----B----M-B--MBM--------B----Bo------B-----M---B-----o----B-BM--?-?EE---?----B---E---M----?--o----?---M---oM------B---
---------o----------o?---B--M-B--------?B-----M------o-----Mo-----M--M---B-----M----M--B----------E-------------------M-----oM---B---?-M------o-?-----?-----E---o-oM----oo-------------BM--?BE----?--E--
-EE-------?B--E-----------B-E-o-------E-----M------------B-B--M---E------o?-Eo-----------o---?-M---o?-----oo-M--E-----------------------o---------ME------E--?--B--EBoM--------B--------o--------?B--B?v
-?-----------------------B--o--oo-----?E-E---B-?------M--------M--M-------o----------o--?---B----B-o-----M---------o-----??E-B-----o---EE----?------BMM-------------M--M----------M------------------Eof
----B-----------------M----B----B---E--?--o--------E---E------------M-----------B-M----oE--MM-----------------B?---BBB-----?----M--M-------------------o-E---o--M---------------B--------?-------------f
--?-------o-----------M---M-o-?M---------o---B---E--E---------E-----B--------E---?--?----?-----E----o---?------M---E---?--------o------?--?-----Mo------o-M----------------?---?------?-M---M------M---f
-M-----------B------------?----?o--E------B----E-----------M-----------------------o---?-----o-----------------BB-----?----BB--B------------?-------oE---?-----ooB------?-BB-M-----------oM--B--?---B--f
-?--------?--M-----------------B---M---B-----------E------B-?--BMEM-o--------------E---M-----?------B---------B-o--------E---MM-------?--o--E-----M---------M-o?o?--?----------M-M-B---?-------o-o--B--f
--o----?---MB---------M---E------B--------oo--M----o-o-----------M-----B-------o------M---------Mo--M---B---M-------------------------M?-Eo-?-------?----E---E-----------?-M---o-?--EM--MB----M-o------f
mMo---------X---M-E-------ME--------M-----------------BB-----------?----------EBB--------X-|------MX----B----------B-E?---------------------------|-XB-------|-E-M------o--------X------|--?-------X---X
XXXXXXXXXXXXXXXXXXXXXXXXXXXXXXXXXXXXXXXXXXXXXXXXXXXXXXXXXXXXXXXXXXXXXXXXXXXXXXXXXXXXXXXXXXXXXXXXXXXXXXXXXXXXXXXXXXXXXXXXXXXXXXXXXXXXXXXXXXXXXXXXXXXXXXXXXXXXXXXXXXXXXXXXXXXXXXXXXXXXXXXXXXXXXXXXXXXXXXXX
