--------------------------------------------------------------------------------------------------------------------------------------------------------------------------------------------------------
--------------------------------------------------------------------------------------------------------------------------------------------------------------------------------------------------------
--------------------------------------------------------------------------------------------------------------------------------------------------------------------------------------------------------
--------------------------------------------------------------------------------------------------------------------------------------------------------------------------------------------------------
--------------------------------------------------------------------------------------------------------------------------------------------------------------------------------------------------------
--------------------------------------------------------------------------------------------------------------------------------------------------------------------------------------------------------
--------------------------------------------------------------------------------------------------------------------------------------------------------------------------------------------------------
-------------------------------------------------------------------------------------------------------------------------------------------------------------------------------------------------------v
--------------------------------------------------------------------------------------------------------------------------------------------------------------------------------------------------------
--E-----E----?-??---o?o-------??-?-o---------Xo--X-?--X---o-?-------XXXX-------?-------------o----------?--XX-----?------?------XXX--o-o?XX--?--E---?---X-X-?--?-?-?----E--?-?--o-?----o------X?-X------
--?-?---o-?--X--E--XX---?--E----?-o-----------X---X---X-----X--------XX------?E---------??---?-?----------X-Xo-E-------EE-------EX-?----?-X------E-----o-XE-?-?-----?------E--?---ooX-----E----XX---o?--
-E-E?----?-?X------?XX--o------------??X--X--?XX-X?XX-X-?-??X????----XE------------X--?E--X--E-----o----o--XX-----o---o?--XX-E----XEE??E-?X?--Eo??-------XoXE------------?----------X-----E----X--------
----X---E-XXE-------X?o---------------X-XXE--XX--XXXXX-------X-------?X--------E--X-EoXEXX------??--------?X-----o----E---X--o?----X-----Xo?-------oo---?oX-?-?--------o-------------XXE?oE--E?-XEEo-o--
----X--T-o-X-E-T----?X---o--?---o?--X-oXXXXXX-X-XEX-X------oX-------oXX-------oo-X---XX-X-?oo--------o--TT-X?XX-X-?o-?--oX?----EE-XX-----X--?--?-o---o???XE?--?-T----E-X?XE---------X--XXo-T-T--TXXo?---
m--o-XX|X-XE---|?o--X-------|-?-|-E-?X--X-XX-EoX-E|XX-?-?--oX-E--o--?X-----o---XX--oX--X--X-|-oXE--XXo--||X||-XXEo---|---X?-?--?--oX?o?-XX--|E------X---X------o|E-----?X----o-E---X-XEXX|?|E|-X|EX?----
XXXXXXXXXXXXXXXXXXXXXXXXXXXXXXXXXXXXXXXXXXXXXXXXXXXXXXXXXXXXXXXXXXXXXXXXXXXXXXXXXXXXXXXXXXXXXXXXXXXXXXXXXXXXXXXXXXXXXXXXXXXXXXXXXXXXXXXXXXXXXXXXXXXXXXXXXXXXXXXXXXXXXXXXXXXXXXXXXXXXXXXXXXXXXXXXXXXXXXXX
