----------?---E-------?------?--?---------E?------------------------?------------------------------------?--E--------E----?------------------E-------------------?------?------------?-E----------------
----------------E----?----------------------------------------------------?-?------E--?--------?----------------o---------------------------------------------o----?------------------------E--?---?--o-
----------------?------------E---?----------?------?-----------?-E--------------------------oo-?------o-----------------------------------------------?-E----------------?----------------------o-------
------o---------?E-??------------------------------------------?---------------------EE-------------??-?-------------------?-------------------?-------E--------------------?-------E----------?--------
-----------o?--------------o----?--?-------?-o---?------------?---------?----?---------------------------?--E--?---------------?-----------------------o---------------?--------------------------------
----------------------------o--o-?----------------------------?-----------E--E--------------?-------------EE-------------?--------?----------------o------o?------------------?---------?--E-------o----
---o--?-------?-------------------------------------?----o----E------------?-------------------------------------------?-----------------E------------------?---------------?--------?-------E------?---
------------------?---?--------o--?----------------------?--?------?-------------??-------------?---------------------E-----?-?--------?------------------------??--?-E----------?--E------?--?--------v
-E---------------------------?------------------?--E---?-----?---------------------oo----------------------------------?-??-----E-?-----------------------E--------------------------E-----------------f
--E---?-----------------??----?----------------?------?---?-------------------?E--------------?--?--o?----------------------?-----------?---?------?------------------------------?E-------------------f
-----o----------E---------------o------------------?--?-------------?-----------?------E----------------?-o------------------------------------------------?-------------E-----------------------------f
-----------------?----------------------------------------------------------o-------------------------------------?-----E----------?o------------??-------------------E-------?------------E--??-------f
---------E-----------o-----------o----------?---------------------------------------------o----------?---------------------------------------------?----------------o---E-E----?-o---o---?-E-----------f
------------------??----?--------------------?-------------------------|---------E--E--------?-----?-------?----E---------------------------?---|---------------------------o-------------------|T-----f
m|-o-|------E-|-|-------|---------?|-------|--------E?---|---o|-|------|||--------|--|-E----?------|-----|--|-||??|o-----|--||-E---|--|-----|---|-------|------E?-o--o---|---||---o|----|---?---||-----X
XXXXXXXXXXXXXXXXXXXXXXXXXXXXXXXXXXXXXXXXXXXXXXXXXXXXXXXXXXXXXXXXXXXXXXXXXXXXXXXXXXXXXXXXXXXXXXXXXXXXXXXXXXXXXXXXXXXXXXXXXXXXXXXXXXXXXXXXXXXXXXXXXXXXXXXXXXXXXXXXXXXXXXXXXXXXXXXXXXXXXXXXXXXXXXXXXXXXXXXX
