--------------------------------------------------------------------------------------------------------------------------------------------------------------------------------------------------------
--------------------------------------------------------------------------------------------------------------------------------------------------------------------------------------------------------
--------------------------------------------------------------------------------------------------------------------------------------------------------------------------------------------------------
--------------------------------------------------------------------------------------------------------------------------------------------------------------------------------------------------------
--------------------------------------------------------------------------------------------------------------------------------------------------------------------------------------------------------
--------------------------------------------------------------------------------------------------------------------------------------------------------------------------------------------------------
--------------------------------------------------------------------------------------------------------------------------------------------------------------------------------------------------------
-------------------------------------------------------------------------------------------------------------------------------------------------------------------------------------------------------v
--------------------------------------------------------------------------------------------------------------------------------------------------------------------------------------------------------
------?----?-?-XX?---------X?-X-X--------E--?----o---?--XEXX---------XX?E-?-EoX-?---------?--------E---XXX-------X-?--XX--?-???-XXoo----?o??-E?-X---?X?---?---?----?o---?--------o----X-------?---?-----
-?-E--o-?---o--X----Eo-----X---X------?-?-o----X----o--oEXX----------X-?------XX-X-----?----o-------?---XX-oo-X-X-----X--o--o-?--X----E-?--?o-?-EX?X-X--E-----------------?------E---XX------?------o---
------o--------Xo?--?-EEo-X---X---------??-??-X?---?-----X?--?-?-----X-X-----X-XX--XX---------E------o--X----?-XE----XEo--?----o--XE--o--------?--XXEX-oX-oX-?------------?o-?---?XE-EX-E-?o-----?--X---
-E----XXXXX---X-------oX-??XEX------?-Xo?---X-X-------E-?-X--?o---?---X-X?X-?X-X--?EXX-------?--??-XXX---X--XX-X--X?-X?------X??EX--?----?---E-?X--X?XXX--XE---?-?--o?---?----EE-Xo-X--X------o---XX----
-TE--oXXX--X--?X------X?-EX-XE-?---T?-oX-?-X?-Xo?X-----X-E?X??T--TTT---X--X---X?o-X-XX------oXTTT?--X-E-X---X---X-X-X-T-?-X--X--T-X-?--XXX--EEXXX--XX-XX--X?X-T----XXX--TT---ooXX-?TX-XX?------o-o-XoT--
m|??EEXXE--EXXX---?-o-X----X---|---|Xo|-XXX--X--XE-E-X-X?XX--X|-||||-X--XX-XXX---X-|XX----X-EX|||??X-XXX--?X----X?-X--|-EX-?o-X-|-XXX-E-XXX-|--X---?XEX--|-X--|?Xo--XX-o|||-----XX-|oXXX|---?----o-X-|--
XXXXXXXXXXXXXXXXXXXXXXXXXXXXXXXXXXXXXXXXXXXXXXXXXXXXXXXXXXXXXXXXXXXXXXXXXXXXXXXXXXXXXXXXXXXXXXXXXXXXXXXXXXXXXXXXXXXXXXXXXXXXXXXXXXXXXXXXXXXXXXXXXXXXXXXXXXXXXXXXXXXXXXXXXXXXXXXXXXXXXXXXXXXXXXXXXXXXXXXX
