--------------------------------------------------------------------------------------------------------------------------------------------------------------------------------------------------------
--------------------------------------------------------------------------------------------------------------------------------------------------------------------------------------------------------
--------------------------------------------------------------------------------------------------------------------------------------------------------------------------------------------------------
--------------------------------------------------------------------------------------------------------------------------------------------------------------------------------------------------------
--------------------------------------------------------------------------------------------------------------------------------------------------------------------------------------------------------
--------------------------------------------------------------------------------------------------------------------------------------------------------------------------------------------------------
--------------------------------------------------------------------------------------------------------------------------------------------------------------------------------------------------------
-------------------------------------------------------------------------------------------------------------------------------------------------------------------------------------------------------v
--------------------------------------------------------------------------------------------------------------------------------------------------------------------------------------------------------
-----E-----Xo?EoX--??-?--E------XXo--??XXXXX-----?--?--ooE-----X?-o--o------?X-X-Xo---?-?---XX--?XX---o--E-o------?---o------XX?-?-----XX-X--?oo-E------?X-?-----E-X?E-X-X----XXX?-XXX----E-----E?---?--
------o--o-X?-XX-?E--E--o-?-----oXXXoX--XEXXX-----o---?---o---X------?------XXX-E-X----X-X?oXX--XX?-------E--o--?----------X-X---?X--E?EXXX---??---?--E---X-?-E-?-??X?XXXE--E-XX----X-?--X?o------o-----
--E--E?-E?--XXX-------Eo----------X-X---XXX-Xo-oE?--E-XX?E-X?X-?-------?--?-?XXX-Xo--o-XX?XXoXXXX-E----?------E---E--------?XEo--XX-----XX----oX-?--?-----X-XX--?----XXXX---EX-X---X--E-?-X-----??E-?---
---------o-oXXX----X------------E-XX--?-XX-XoX-X?X-----X--?-XX---------??-?--?X?-X-----?XXX--XXX--?--?----------------?E?--EX----X----?--X---EXX------?---oXXoX------?XX?XX---X?----XEX-oEX----E-o--E---
-----TTT--T-XXX----X--?--T---?-----X-?-XXX-?X-Xo-?X----?XX-XX-----?--?--To----X-X--X?---XX?oT-X-?Eo?---?o-----?---?----XE---X??--X-oT---X-?X-X-X?--?--?--?--XXX--?----oXXX----EX---T-X-XXX?----TEX--?o--
m-o--|||--||XXX?--XXo----|--|XXX|E--X|--X--?EXX--XXX--?-X?XX---?--?X-XXE|--?E-X-X-X?-E---X--|X?----X-o------X-----|o---X---X-X--?-X-|---oX?-XXXo----?||E---XX|XXXX-o-XEX--X-X?X----|X?--X------|-|X-|X--
XXXXXXXXXXXXXXXXXXXXXXXXXXXXXXXXXXXXXXXXXXXXXXXXXXXXXXXXXXXXXXXXXXXXXXXXXXXXXXXXXXXXXXXXXXXXXXXXXXXXXXXXXXXXXXXXXXXXXXXXXXXXXXXXXXXXXXXXXXXXXXXXXXXXXXXXXXXXXXXXXXXXXXXXXXXXXXXXXXXXXXXXXXXXXXXXXXXXXXXX
