--------------------------------------------------------------------------------------------------------------------------------------------------------------------------------------------------------
------------B--------------------------------B-----------------------------------------------------------------M-----------------M----------------------------------??-------------o--------------------
------------E--B--------------------E----B------------------------------------------?-----------------------------------------------------------------B------------------------------?------------------
-------M---------------------------------------o-------------------------------------------------B--------------?oE--------------------o---------------------------B--------------------?---------------
-----------------------------?-----E---------------B------B----?--------------------------------------------------------------------------------?----------------------------------------------oE-------
-----------?----------------------------------------------M------------------B-o--------------------------------------------?-------------------------------------?-B-------------B-----E---------------
--B-----------------------------------------------------------B-------M-------------------------?--o--------M-------------MM-B------o-------E-----------------------------------------------B-o---------
-----?-----------------------------------------------M-----------------------------------------------B--------------?----------M---------------------------------------------------------E-------------v
---------?-B----o------------o--------------------M----------------------------------------------------------------------------o------------------o--------------E----------?M-B----------E-------------
----M--?----?M--M--EE---E-X-M----?-------EB---XXM--B-----XM---------o?---B--M-ooEM----o---------?X-B-----o------o-EE---o----E----E--EM---o-E--------B-o-?--?------oX---?-----M-E---o--?M-?-----B--------
--------B-----MMB--E-?---M-X-----M---------E-M-X---?M?--X----o?--?-------E-o---?-----------o-M----X-------M--?E--MEE--M--?-------------o----?--Bo--o-E----BM?----X-E-?--B---------Mo--E-o-??-?-?M-o-----
-M-oE-----o----------------XX-o--?---E-M---X-XX-E----?XB-----B----------------?-E-------E----?---X---E-----B--B-X----?-E--X------E----?-oB--M--M-----E--B----o-o-oX--E--o-E-B-E----B---o----o-EB-----o--
-?-----M-M----?-M---B-?M---MX--??-B-o-X-M---XX--------X-BM-o-----E--MM--?----B-M--XB-o---EB-o-M-X?--M----M--o--o?XB-E----X--M-------B--E---?----?----E-B-M--E----EX-B----E-E-X--MM--o---------------E---
------oX--M--X-----M--o---o?-X-----B-TT----EX--Moo--o-XEXM---B--M--o-----??--X?X?--X--M-XM--oE--X?----o--?-----XX-X----X--X-XXE----?--oB---B---oXEBE--M-----XE----EX------o---XM--B-----E?Bo-BEM-?-o----
m-XM|B--XX-X-X---M---B----E-X-XBM-?oX||o-?MX------E-E-XX--B|?BB----X-X---?oM|X?XXE-B-XXX??-B---X-oXXo-XM-XX---XoXX-XE-X----o----X--XB--XX-M--X-X?----o|M-B-B-XEE-XE-X-XM-BE-o-X-----X--?--?o-X-o-X--?X--
XXXXXXXXXXXXXXXXXXXXXXXXXXXXXXXXXXXXXXXXXXXXXXXXXXXXXXXXXXXXXXXXXXXXXXXXXXXXXXXXXXXXXXXXXXXXXXXXXXXXXXXXXXXXXXXXXXXXXXXXXXXXXXXXXXXXXXXXXXXXXXXXXXXXXXXXXXXXXXXXXXXXXXXXXXXXXXXXXXXXXXXXXXXXXXXXXXXXXXXX
