--------------------------------------------------------------------------------------------------------------------------------------------------------------------------------------------------------
--------------------------------------------------------------------------------------------------------------------------------------------------------------------------------------------------------
--------------------------------------------------------------------------------------------------------------------------------------------------------------------------------------------------------
--------------------------------------------------------------------------------------------------------------------------------------------------------------------------------------------------------
--------------------------------------------------------------------------------------------------------------------------------------------------------------------------------------------------------
--------------------------------------------------------------------------------------------------------------------------------------------------------------------------------------------------------
--------------------------------------------------------------------------------------------------------------------------------------------------------------------------------------------------------
-------------------------------------------------------------------------------------------------------------------------------------------------------------------------------------------------------v
---E--??------------?--o--------??----?o-----?-------o----?---?--o----?--E--E-?--?---?-------?--o----?--?--o---?-?---o--?--------?E---??------E-----------?-E----?--o------------?---E----?-----------?-
--?o------o----?-----?-o----------o------o---?-E------?---?-E---?----------o-----o--o-?----------o--o------------------E---o----?--?o----o--?-----o--?--------?--E---------------?----E--------------?--
---?--------?----o-?-E--?----E-----------o--?-E-----------????-------o--------------------??-----?-----E-----------o--o------------?----E----E-----------?--------------?---o--?------?------o--??--E---
---E-EE-------o-------?--------o-------?---?-------------?-?-----E--?------?---o-----------------o--o--?--??---E--???------o-E-E------E--E-----?--?-------?o------------------?--??------?-E---?--------
-?--o--?---------?-E--E--?------E------E--------------------o--o-?-------?---------??--?------------o--E---?---oo-----?-----------?-?---------oE--E-----o---?----?----o-------E------------------o--o---
---?--?-o--------?-------?E--?----o--------E--o-----?---?----?------o----------E-----------Eo--o---o----?-------------------------o?o?--?------------E?-?----E----------Eoo--?o?-E----------E---------o-
m-XX-o|E-|X-E??|E-?X-|---XXXoE-X------X-o-X-X--XoX--X?XXEX--XX--XX-|-X|-XX|?----?|--X-X---E?X--|-XX?|E|X--EX?E-XX-X----X-X------|-?XX--X?XXX-XX-|----X-|-X-||-o---X??X-XX?--?-X?|EX?EoX??X-EE-|-?-?XoXX-
XXXXXXXXXXXXXXXXXXXXXXXXXXXXXXXXXXXXXXXXXXXXXXXXXXXXXXXXXXXXXXXXXXXXXXXXXXXXXXXXXXXXXXXXXXXXXXXXXXXXXXXXXXXXXXXXXXXXXXXXXXXXXXXXXXXXXXXXXXXXXXXXXXXXXXXXXXXXXXXXXXXXXXXXXXXXXXXXXXXXXXXXXXXXXXXXXXXXXXXX
