--------------------------------------------------------------------------------------------------------------------------------------------------------------------------------------------------------
--------------------------------------------------------------------------------------------------------------------------------------------------------------------------------------------------------
--------------------------------------------------------------------------------------------------------------------------------------------------------------------------------------------------------
--------------------------------------------------------------------------------------------------------------------------------------------------------------------------------------------------------
--------------------------------------------------------------------------------------------------------------------------------------------------------------------------------------------------------
--------------------------------------------------------------------------------------------------------------------------------------------------------------------------------------------------------
--------------------------------------------------------------------------------------------------------------------------------------------------------------------------------------------------------
-------------------------------------------------------------------------------------------------------------------------------------------------------------------------------------------------------v
--------------------------------------------------------------------------------------------------------------------------------------------------------------------------------------------------------
----E-Xo-XX--?E--X-XE-??------o---?---E-----E-?------o----------------?-X--o--E---oXo-----X--X--??-------E-----X-----X------Eo-------?--?-?-X-X---?--------?--?o------?-----?-E-X-XXE--o--------X-X-----
-------X-X-----X-EX---oo--Eo-------?--E----o?------o--------E-E?--?-----X----------XE?-----XX----E----E-----?-X-----?X------EX--?-------E?-XXXo-------?------------------------X-?X?-?-------?--EX------
--------Xo-----EXX---E-E--?-?---------------XX---oo?--------?-Eoo-?---o?XX---XXXXXXo-?-?--?X---oE-------o-o-?-X?XXXX-X-?--?-X---oE-?---?X?-XX-----?--------?--o----E---E----oEX-XX---E-o--------X?-E----
--?-----X-?--XXXX-X------oo----?-E--?--?----X--o--o--?XX------?--?o------X-XX-XE-X-o--X-?o??XXEX-------------EoX-oXX-Xoo---X-?--?-E?---EXX-XX--?-o---E-?-??-----o---?E----o----XX?--Xo--?-----Xo-XXX----
-----o-X-|XX?XX-XX------?--?-ETXXXXT-----oE--X?X???---XXXX-X-----?---?-?X-XX-o?X?X-XoX?o---X-XX---EE??-?o----E-XXX-X--X--XX-T-?-T-?--o--X-TX?X-----?----??X-o--?-T-----?-?-oEE-XXXXXX-T??---?--XX-X--E--
m-?-|-XX-|X?-XX-XE-o----?X-o--||XXX|---??EE?-XX?--X-X?X-XoXX-o-E--?-?|---XX-X--XX-X-oXX|o--?X-X?|XXo|--X|-----o-X--?X-XEX-X-|---|oX-?-E--X|-X?--oE?-?--XXX--|-EE-|o----oXE--X?X-oX-XX-||---o-XoXX-X--o--
XXXXXXXXXXXXXXXXXXXXXXXXXXXXXXXXXXXXXXXXXXXXXXXXXXXXXXXXXXXXXXXXXXXXXXXXXXXXXXXXXXXXXXXXXXXXXXXXXXXXXXXXXXXXXXXXXXXXXXXXXXXXXXXXXXXXXXXXXXXXXXXXXXXXXXXXXXXXXXXXXXXXXXXXXXXXXXXXXXXXXXXXXXXXXXXXXXXXXXXX
