--------------------------------------------------------------------------------------------------------------------------------------------------------------------------------------------------------
----------------M-----------------------------------------------------------------------------------------?E------------------------B----B-E------------------------------------------------------------
-------------------------------------------------------------------------------------------------?-------------------------------------------------E------------------------o--M-------------------M----
----------------?---------------------------------------M-------------------------------------------------------------------------E------o--B-------------E--------------------o------o-----------------
---------E--------------------------------------------------------B-------------------------------M-EB------------------------------------------------------------?---------------------------o?--------
----B--------B--B------------------------------------M---------------?-------------------?B------?-----M-------------E--E-?------------------------------------------E---o------------------------------
------------------------------------E---------------------------------------------------------------E-------------------------------------------B-------------------------B------------?----------------
-------------------------E-----------------------?-----------------------------------B------M-E-----------------------B----------------?-------------------------------------o?--------M------------B--v
--M----------------------------------E---------M---?---X--------------------------------?--------------M--------X----------------------------------------------------------------------------------M-E--
--EX-XE---?----------o-----?---------X------E--X----oX-X------?---------o-XX-----?----XoX----X-?--?---E-oX-----X------B----B----XX---------E--XE----XX-?----o----B--?------?------?-------oX------XXXo--
----XXX--E?--EE-----o------------X-?-----??----X------X?-oE-----------o-?E-XE-X--E--XXX-X?---oXX--o-----?XX-EBXX-B-------o-----XX---?MX-----XXX-XX--XE----?-?E----E--------?---------M--X?X----?---X----
--?--XXo-----M-E?---XX---o---?---X-XE--E-?--?-?X------XX-XX---o-------X?X-??XX------XX-X-X--o-X-?------o-XXXX-X?--------?-------X-XXEX?-----oX--X??XX---o--o---------------X-?--B-------?XX----BXoX?oX--
-E--BX--------E---XXX---X?------o-X?X-E---?E---?X??----XXX-M------B-E-XX--X-X---E--?X-?-X-E--XXE------E--Xo-X-XX-?---------o---X-oXXXX---XXX--XXoX--X--?---?------------o---X---?o----o-XX--o?---XXXX-?-
----X----?--X-----EX-X?X------?XEX-X--?oTXX--E--XXT--X?XX------T--T---oXXX-X-XT-T?-EXXEXX---XB---E?E?----XoX-?-X--TE-ET-o---o--?XT-XX-E-o-X---XXXX-X-X--------------E--T-X-E?X--EE--T-EX?--oE?E--?XEX?--
m-EXX?--M-XX---EX-X?-oXE-?X--?-EX|-X?Xo-|X|--E--XX|?-?X-XEXo--X|--|X--|?-|XXXE|-|X---X-?Xo-?-X-X-X--?X---|X|XXX---||XXX--X-|X-XXX|-XX---X?X--X-XXX--X--?|X|-----oo-?-?X|-XEEE?X-|MEX|---X-X--X---XEoX---
XXXXXXXXXXXXXXXXXXXXXXXXXXXXXXXXXXXXXXXXXXXXXXXXXXXXXXXXXXXXXXXXXXXXXXXXXXXXXXXXXXXXXXXXXXXXXXXXXXXXXXXXXXXXXXXXXXXXXXXXXXXXXXXXXXXXXXXXXXXXXXXXXXXXXXXXXXXXXXXXXXXXXXXXXXXXXXXXXXXXXXXXXXXXXXXXXXXXXXXX
