--------------------------------------------------------------------------------------------------------------------------------------------------------------------------------------------------------
------------------------------------------------------------------o---------------------------------------------------------------------------B--------------------B------B----------------B-----M------
----------------E-----M---------------------------------------B----------B---------------------------------------------------------------------M-----------------------------o--------------------------
-------------------------------------------------------------------B------------------------------------------------------?--------M----E-----------M---------------------------------------------------
---------------E--------?-------?--------------------------------------------E?--------------------------------------E--------------------------------M----------------------------------------o--------
-----------------------E-----------------------?--------------------------------------E-----------------------B---------------------?----M-------------------------------------------E------------------
------------------------------------------------------------------------?o---------E------------------------B---?---------------E-------M---------------M-o--------------?--------------?---------------
----------------------------?--------------------------------------------------o------------------------------?---------------------------------------------?------------------------------------------v
--?------B--------M-M----------B----------X-------------------------------------------------------?----------------------------o---------------------------------------------M--------------------------
-EX----B?EM-----M-------?B--M----B-X---BE-X-X--M---?-------o?-oBE---------M----M-----??---M---BoB---MM--B-----M------BoB---B---BXB-o--B----o-B-M-X-----o-------M---B-o------------M----B-----M--MEM-----
--------B-o--B---Eo-----E------M-oX---EoE--X---?o------B----M-B--o---------BB?-----B--?oM?M-?oE--M-E--o----o---------o-----oo---XB-XB-MM----MX--EXB?-M-----E---M-M?-?E---------------E----XM------------
-o---M--?-MM-EE--E--M-----o--------XX-----MX----M-E-B-o--E--B-----E-Eo-------X--M------B-------E-M--B-BE--BE-?---B-----MB--oM----X-X------?-XX--X-Mo---M--------------o?----------M----Mo-XMXB-Mo?---E--
-E-X-B--o----BB-----B--oX--BE-?o-X--X------X---------E---EEM---EEo--E----?--o-X-X-X----X------o---MoB--XX----?BE-E----M------------B?-o-E?-X-X-XM-------------------?--B--E-Eo----o--M-?--?X-?o-o--M?---
-o--X-EMXXo-XM--XEM---X-XX---M--XX--X--?--?X-?B-----------E------M-----oMo---?oX-X-XB-E-o---E-M-B-XB-T-X-o-?Bo-o-----M?--?MMBM--MBX-------TX-BXX---XE-B-EXE--Mo-E---E---X---o-T----ooM---o--X?-M--XXXM--
m-E-X-XXB-X-oX--XXB-o-XX-X---M|?-XM|X---oX-EX--B--E--M-BB------B---?-B--X---?-X--?X---X-X---XX--?B-X||E-XE-X-----EM-E--?X-B--Xo--X-----?-o|X??X-----XE---MX---M---?-EX-oXMo--B|E?-B-XX---XE--XX---?XX---
XXXXXXXXXXXXXXXXXXXXXXXXXXXXXXXXXXXXXXXXXXXXXXXXXXXXXXXXXXXXXXXXXXXXXXXXXXXXXXXXXXXXXXXXXXXXXXXXXXXXXXXXXXXXXXXXXXXXXXXXXXXXXXXXXXXXXXXXXXXXXXXXXXXXXXXXXXXXXXXXXXXXXXXXXXXXXXXXXXXXXXXXXXXXXXXXXXXXXXXX
