----?----------------o----------------o----?----------------------E--------?----o---?----------------o----?------E---E-------------------------------E-------------------------------------o------?-----
----------------------?------------------------?------?-------Eo-------------------------------------------?----------------------------o-----------?--?--------------------?------------?--------------
-----------------------o------------?--------------------------------------------?----------------------------E-E-----------------E-----o---------------------------?-------------------E---------------
----------------------------E--------------?---------------E-------------------------------------------?----E-?---------E----------------?------?-------E-o---------?------o----E------------E----E-----
-----?---------------??-----E----?----?-------------------E-------E-------------------------------------------------?-------o----E-E--------?--E------------------------------------?------------o----?-
--E----------o--------------?-----------------------E------------?-------?-o------------?----------?--------E-----------?-------?E-------------o----------?--------E------------?-----------------------
-?------------?-----?--------------------E-----------------------------------------o--------------------------------E---------------------------------------------------------------------?-------------
--------?---??---------?------------o------o--------o-?E-----------------------?-------------?------------------------------E------o---------------?---------------------------------------------------v
---E?-------?o---------??---?--------EE------------------??--?E----?----------?------------E---?-?-E---------o---?----?---o-?---?------------?-?------o---o?--oo---o---------?Eoo-E---?--?-o--?o--------
---------E??-E--E----oE--------?E-oo?--o-?----o------o-?-----o-o--------?----?-o-------------?------??---?--??-?-----------------o-------?------?--?--E-----?-o--------o-o------E--?-??---Eo-------o----
---oE--Eo-----??--?-----E------?--?--------------------E------?-------?-E----o------------?-o-----o----?--o--?---?-----?------?-?o-o--E-------------Eo-?-??------?----E--E--------------E--E-----?--E?--
------------??-?--------------------------E-------?--E-------E?-------?----?---E------EEE--o?-o---o--E-----?----?o--------E---------?o-----E??E--------?-----o?o---??-??-----?--?-?---------E?-?E-oE?---
-----o-E-------??E?--?o------?-EE---o----?--------?---------?E----------o-----?---?--?------?---o------------Eo--o-------o---o------------o--E------------?---?--E??---------E----?-----o-------E---??--
----|E-o---o---o-To-------??------|TE-?---|-E?--?------?ooE-------?-?-Eo---?--------E|?-?-------|?---o-|-------o----??---------E-?E---?--|-|T-----------o------o----o|----|-----|-|--E|--E-||----?o|o|--
m||-||||-|-Eo-||||||-|---E|-|--?-|||?--||||?o??|E|--|o-?|-o||-|o||||-||??|||-E|--|-??|||???||||EE|-E|-||?-|||--|?||o|-?-E||---o-??|E||--||E|?-||E-|-|--?-||-|-||||-?|?-||?|-|E-?|E|-|||-|o||||-o-o||-||-
XXXXXXXXXXXXXXXXXXXXXXXXXXXXXXXXXXXXXXXXXXXXXXXXXXXXXXXXXXXXXXXXXXXXXXXXXXXXXXXXXXXXXXXXXXXXXXXXXXXXXXXXXXXXXXXXXXXXXXXXXXXXXXXXXXXXXXXXXXXXXXXXXXXXXXXXXXXXXXXXXXXXXXXXXXXXXXXXXXXXXXXXXXXXXXXXXXXXXXXX
