--------------------------------------------------------------------------------------------------------------------------------------------------------------------------------------------------------
--------------------------------------------------------------------------------------------------------------------------------------------------------------------------------------------------------
--------------------------------------------------------------------------------------------------------------------------------------------------------------------------------------------------------
--------------------------------------------------------------------------------------------------------------------------------------------------------------------------------------------------------
--------------------------------------------------------------------------------------------------------------------------------------------------------------------------------------------------------
--------------------------------------------------------------------------------------------------------------------------------------------------------------------------------------------------------
--------------------------------------------------------------------------------------------------------------------------------------------------------------------------------------------------------
-------------------------------------------------------------------------------------------------------------------------------------------------------------------------------------------------------v
----o-?E??E-------------------E?------?--?--E-??-----------o-------?----o--E----?-?E--??----?-------?----?----E?--------------E?-----------?----------------------??--?---?-?--E---------?---------?----
------------o-------oo--E-----o------------?----o----?--???-----?------E--?-----?-?----------------?-o-------?----------?-?o---??-E-------?--E-------E-o-----------------o--E-----?-------------?-------
---??---------E----?--?-------o-o--------------?---E?----------o--------------------?--------------o--o-E-o-?E?-------o-?----------?-?-o-?E---?-----E------o---o-E---?-----?-E-----?-----?-E----?-------
---------?---E--?----E---o?----------------?E--?-o-?------?-------??-o--------?o--o----------E------o------E--------o--o----o-?--E???--o---??---o-o---EoE-E--E-----?-----------?---E--------?----o---?--
---E-o--?----------?---------o----?--------??------------?-----E-----o-------o---?E--E---?-o-o?--E-?-?--?--o------------o---------?---------E-?o?--?-?-?-------E-----------?------------?-?-----?-?-----
-?-----?--E-----o-?oE--------------o-----EE-----------?----------------?E----E----?----E??-E--o---?---??E-----o--------------?E---o-oo--------E--o----?-------?-E-----------------EE----?-------?--E--o-
m-?EX--X-X---|--EX??-X-|X|E|X-EXX?-o|----X---XX?EE|X--X-|oE---X|XXE|-Eoo?XXX-XXE|oXX|X-E---X-XXX-X--X---X--o---?-|?-X-XE-o-??-?Xo-XE--XX-XX----X-|oX-?E??--X-X-E-|o?--EXXXXX|------o-X-E-?---XXE?-?X?E--
XXXXXXXXXXXXXXXXXXXXXXXXXXXXXXXXXXXXXXXXXXXXXXXXXXXXXXXXXXXXXXXXXXXXXXXXXXXXXXXXXXXXXXXXXXXXXXXXXXXXXXXXXXXXXXXXXXXXXXXXXXXXXXXXXXXXXXXXXXXXXXXXXXXXXXXXXXXXXXXXXXXXXXXXXXXXXXXXXXXXXXXXXXXXXXXXXXXXXXXX
