--------------------------------------------------------------------------------------------------------------------------------------------------------------------------------------------------------
--------------------------------------------------------------------------------------------------------------------------------------------------------------------------------------------------------
--------------------------------------------------------------------------------------------------------------------------------------------------------------------------------------------------------
--------------------------------------------------------------------------------------------------------------------------------------------------------------------------------------------------------
--------------------------------------------------------------------------------------------------------------------------------------------------------------------------------------------------------
--------------------------------------------------------------------------------------------------------------------------------------------------------------------------------------------------------
--------------------------------------------------------------------------------------------------------------------------------------------------------------------------------------------------------
-------------------------------------------------------------------------------------------------------------------------------------------------------------------------------------------------------v
--------------------------------------------------------------------------------------------------------------------------------------------------------------------------------------------------------
---o?-----EE----?--MM-o---B-EE---??------M--E-----?--M-?M------?--Xo--M-----?B--M-------?--------EM----B---ooB?-------?-o-E--?T--o--oM?B-E-----B?-E---M--E---M-?---B----M-EE--?-----B-------?----oo?----
----?--E------M--o------?----?-?-??----B-M-o-o----E--E?---o--E--?--X-XBo------B-------M-M---------o--------?---EB-----E--M--E?|E-M----E-ME--------E--------------oM---B----B-o----B--?o---M?M-M---------
---oMB---M--E-ET---?B?-oM--TM--?----E-?---o-?--?---?---------?-o----XX-----------o-?----T--Mo--T---T---M---------oo-?E---M----|----M---B-E-------B-?EM------------B--T-o---?------T------B-EM---?-------
-T----MToEo-T--|-M--T------|-T--T---T---o-XB--oooB-?B?--o----B---MT-EXX--E----T-ET--BToM|-?----|E--|?M-T--------B-o-T-?-M--X?X|----B-X----o--------oTE---M---B-------|-MT---------|--E-T?MET-TB-o-------
-|-T--B|TT--|-T|-XMX|-M---o|E|--|--T|---BT-XXT--TTMT--BTE--oT-----|--X-----TB-|--|-T-|--|---T--|TTT|---|oT----T-TT--|?TT?-B-XB|?T-?TTX-ET?-T-T---?--|-E----E-T-oB--MT|TM|---TT---E|---X|-T-|B|-oTo--T---
m|-|---|||--|-||-XXX|------|-|-X|--||--X-|-X-|--||-|---|----|-----|---XXX--|--|-X|-|-|-X|---|--|||||---|-|-X--|-||--|-||---X--|-|--||-XX|--|-|------|------XX|------|||-|---||---X|---X|-|-|-|--|---|---
XXXXXXXXXXXXXXXXXXXXXXXXXXXXXXXXXXXXXXXXXXXXXXXXXXXXXXXXXXXXXXXXXXXXXXXXXXXXXXXXXXXXXXXXXXXXXXXXXXXXXXXXXXXXXXXXXXXXXXXXXXXXXXXXXXXXXXXXXXXXXXXXXXXXXXXXXXXXXXXXXXXXXXXXXXXXXXXXXXXXXXXXXXXXXXXXXXXXXXXX
