--------------------------------------------------------------------------------------------------------------------------------------------------------------------------------------------------------
--------------M-------Eo--------B----B-------------------------M-------o--------M------------------------------B---------------------------------------------------------------E--M---------------------
-----------------------------------------------------o?-----------------------B-------?---B------?------o-----------------------------------------------------------B?---B-----E---EM--o----------------
---E--o----------?-----------------------------------------------E------------------------B-----------------------M-E---------------------------------------------E------B-------------------M----------
-------------------B-------------?--------------------E----E------------------------------------------------B-E---------------------------o-?-----M---?-----o---E--M-------M----------------------------
----o-----------B----------?--------------?---------------------------M------------------o------------------E-o--------B--o-B--E--o----?----?------------E--------------------?-------------------------
-----------------------------------------?---B--------M-----B-E---------------o?-----------------------------------------------------------------o------------------B-----------Bo------E--B------------
-----------------------M--M------E-M-------B------------------------B-------------------------------------------?---o----------B------------------B-----o--------------------------?-o--E--------------v
--------------o--M------------------o------?E----------------E---?----------B-----------------E---?-------------------------------------------M-----E----------B-------------------------B--------------
-?---------B?-----M-------EBB----M------o--?-M-------|--M-------?--E----M----oo--B--------o--?E--M?o--o--o---B-------B---------?---B------?B-oE---B-----?-----o-?---B-M------?E---------E-BE?M----------
--E-----?-B-------M-?oB-----------M---oo-?M---?------|---X--EE?------?---?------EEB---M----oE-EE-?----o-M-o-o------?-o??---M--Mo---Mo--o---X-----------------o-o--o---M----?B-MM----T?------------------
---o--o-?-----o--o--B-?-----M---------B--M-------?-o-|--XX----B-B-----?M?------o--E-------o-------M-----T-X-XE--------B-----TE-----o----X?X-----M-?B-E-M--M?-----EX-------BM--M-?-MB|-E-BM?--M----------
--E-----------B----------?---|---T--B-E-----o--------|--X-MT--B-BM-|----EEM-?----E----EB----TXEo--?-M---|---X?|--o-B--E---M-|--------o---XMT-ME---?-o-----X-E------XX-o----E-E-T-E?-|-B--E--------------
-E-T-o-----TT-T-o---TT------T|--T|---------XX-TE---|-|?X-Xo|E|-EE?-|-----XXB-BMT|-T-o-MT----|-XXX-T--T|-|T?XXX|T----?|----o-|------M?B----X|--TBTT?B--T---X-T-B-----X-?E|oM--M-|M--B|--EoTTE-|----------
moM|-|----B||-||---X||BX--X-||-B||-X-|-X-|-X|-||-XX|-oMXX|-|-||----|-|-|-X|-|-X||-|--X-||---|--X--|-|||-||--XX|-B----|--|-BX|-------||-X-XX|-X|M|||-|-|-EX-X|--X---?XX|-|----X-|---X|----||--|----------
XXXXXXXXXXXXXXXXXXXXXXXXXXXXXXXXXXXXXXXXXXXXXXXXXXXXXXXXXXXXXXXXXXXXXXXXXXXXXXXXXXXXXXXXXXXXXXXXXXXXXXXXXXXXXXXXXXXXXXXXXXXXXXXXXXXXXXXXXXXXXXXXXXXXXXXXXXXXXXXXXXXXXXXXXXXXXXXXXXXXXXXXXXXXXXXXXXXXXXXX
