--------------------------------------------------------------------------------------------------------------------------------------------------------------------------------------------------------
---------------------------------------------------E---------------------------------------------------------E--?--?-------------------------------?---------?-----------------?------------------------
----------------------------------o-------------------------------------------------------?-----E----------E-------------------------E-------------E----------------------E-E-----------------?---------
------------------------------------------------------------------E------------o-------------E----E-------o--------------------------------------?-----------o------------------------------------------
----------E----E-----------o------------?----------?--------------------------------------------------------------------o---------------------------------------------------?-------------------------?-
------------------------E-------------------?--------?------o----------------------------------------------------------------------------------------------------------------?-------------?------------
----------------------------------------o----------------------------------------------------------------------------------------------------------?----------------------??---------?------------------
----------------------------------------------------------?-------------------------?------------------------------------------------------?------?----------------------------------------------------v
--E----------------?---?--?-E--------------------------------------------------------------------?-------------------------------------------------------------?-----?-----------------E--------?-------
--??-------?--o----E----?--o-o---?--------------------?-------E-E?-?---?--o-------o-----E---?--Eo----E?E------?-o------------------?------------?E-?--------?---E-----E-?---------?------------?-?---o--
--------?-----------------E----oE?----E-?----?----------------------?--?----?-------oo---E-----?------o-?--?-?---------E--?-----?---------o--------------E-----------o?o------E?o---?-E----o------------
----------?--------------?-Eo--?-------E---o------?--E----E-----?----E--o---?------??---?E----?--------?T?--?---------E-?-?--?-?---o---------E----?----------o-o---?EE---o----?---E-----E--oE--?----?---
-?--o--?---Eo-?-----------?-E-???E?-o?----?---?---?----------o--------?---o?----?-?E-----T----?--o--?---|o-?----------o?-E--?---------------?-T-o-?-o------E-------?-----------------E-----?--E-o?----?-
-o-?-----------?--T?------T-E--T----?--?---?-----EE?------TE-?E--o----?--------------?-?-|EE----?--o-T--|---?E---------E--?o-----------?-T----|T-------E---o----T----T--??--?--E----T?-?------??-?E---?-
m|o-------X-----oo|-o--|--|----|-----?-?-o--E---o|?-|-----|?-?---X?-----?-?-----?-X-?o---|--E-X?---o-|--|E--|---E--?--|-?X---?--?E--E-E--|-o?o||-o--------?------?E??|o---?-|o-o--X-|-o---o-----?o-?X-X-
X--XXXXXXXXXXX-XX-X-XXXXXXEX-XXXXXXXXXXXXXXXXXXXXX-XX-XX-XXXXXXXXXXXXXXXXX-XXXXXXXXXXXXoXXXX-XXXXXXXXXXXXX-XXXX-XXXXX-XoXXXXXXXXXXXXXXXXXXXXXX-X-XXXXXXXX-XXXX-XXXXX-XXXX-XXX?X-XXXXXXX-X-XXXXXXX-XXXXXX
