--------------------------------------------------------------------------------------------------------------------------------------------------------------------------------------------------------
-------------------------------------------------------B?-----------------------------------E------------------------------------------------------------------B--B---------E------------?--------------
-----?-o----------------M--------------?-----------M----M-------M---------M------o-----?------E---?------?---------------------o--------------E-----------B----------E----o-----------E?--?-------------
----ME----o-------------E-----------B---?------?---?-------B----E----------------------B------------B------------------------------------MB-B---o-------------------------------------------------------
-----------------------------M----M--------------------------------------------------------------------B-?--------------E-?---------------------------o--M------------------------------E----E----------
----------?B-------B-----------------?----------?-------?---------------E----------------------E-----?---M--------------------B-------------------?-----------E--M-----B--------------------------------
----------------o------------?o-B------------?--------------------?-E-----------------?-----------------E----------?---------------M-------------MB-----------B-----o-------------?-----E---------------
--------E-------------------------------------E-?-------------------------M------E---M------------------------oE----------E--------------------------E------?------------------------------------------v
------M---?----------------------B-M---------------B--------------------------??---------------B---M----X---------------------------------o---E----E--M--o----------B--oB-o----------------------------f
------E-MME-?--o--?----?-M-----EM-o-M-------o?---?oEBM-------------?----E-M---B-XE--EM---E----?-------?X-?-o---E-BoM----M---------M-?-----o-----?-----?B?-EB-o-----?-B---B-B----B-------B--------------f
-----M---?-----------EB----M--------B-E----------B------?----------o-----o---M-X-M-------oE-------------X--MM-o--------B-o-?-B----?o--oEX------E-----B-o--o--?B-----B----?Xo---B-----M---B-M-?---------f
----M-----E-BT-------?--o?--o-------To----------------o------M-E--E--B----TM--XoE?-M--E-Xo-----MB-ET-o--X---oM-----?--E--o--BBM-B-------XM-----------M------ooB?---M---o-X-X--M-?-----?M---BB----------f
--MEo-oMo----|-T--oB-TT---T--E|-----|--M--TE---E-M-----To--M-E-BM---------|--B-X-T-E-X--X-M------o-|----X--T--BBT---------B------T---M-X?--o-----B-------T--B?T-M---MM-BoEX--X?--------------E---------f
--BT------?X-|-|----?||-T?|T--|----T|-T---T-T-ooo-?-BT-|-T--?----T--?---?BT--X-XX|-MX--BX-------?--|-X-----|-?ETTT--TT-X-MXXM---?|--Mo-TXB-M--o----T?T?--|--oo|---T---o----o-XE-T-TMT-M-T-oo-X---------f
m-B-----X---X|-|-B--X||o|-||--|-----|-|---|-|-B------|-|-----X-|-|---XX?XM|--X-X-|-X---|BX-----XX----XXXX-|----|||--||-?--X--X-X--BXXXX||------X---X-|-XX|-X--|---|---|-|-XXX-X?|-|-|-B-|BXMX----------X
XXXXXXXXXXXXXXXXXXXXXXXXXXXXXXXXXXXXXXXXXXXXXXXXXXXXXXXXXXXXXXXXXXXXXXXXXXXXXXXXXXXXXXXXXXXXXXXXXXXXXXXXXXXXXXXXXXXXXXXXXXXXXXXXXXXXXXXXXXXXXXXXXXXXXXXXXXXXXXXXXXXXXXXXXXXXXXXXXXXXXXXXXXXXXXXXXXXXXXXX
