BET|--M-|---B--XTT??XE-X--?--|XXT-----E--TB-MT--B--Mo-oM-XBEBoX---o-|X-XE--------X------M--oB--???M-oM|oB--B-?EB||||?T|----?ME--??-M---XM-XB----E?--o-X?---|oMTEM|B-T-E--B--o-Bo|oM-o--oB?-o?-?-o?X-XB-?
X-BE|T|--?XXo-X-X|M-M-EE-|-|-?|T-??M-MM--o??-B|-EE-|?--|--|E??-oEE-B|---XE-?XM---TTX?|o|---MBEB--|E-----o--B???---MX?-XT?-EE--X--??--XXB-T-?--??-|-|?-M|-X-T-ME-EEX--X|X-TMoB|-T--?-X-?E?-?o---B---TBXEM
M?XoT--EM---?|-|-MoT--?-X-XM|-TM---MMX-B-o-E----B---E-T-E-M-T--BETBT|B--E---E-ME?|o---|E|--E?M-M-MBEM-oM-E---B|EX--MT-o--?o-----T?-X|----?|--B?-XMM|E-BB-|-B?E?E?---B----M|?----E--T----B?T-EXE---?Xo-BE
XMM?o--T|-?---XMX-E-T---X|-----?E--XE--M-ETEM-BBoB-METB?-?B-----E---B-T-----E--?-ooo--E--EBBM-?-o-|ME--o|E-----?---M---o-|--E---BM?-Mo?XTM-EMT--M?-EoXX-MX--TT--EME-|X?BM----|-MM---B----o|E-?-XT|---T|B
T|--X--TT--?--?|-o-BTM-|--ETMoB-M-B--TX-EoEo|-X----M-B--MTT---|-EB--E-|Mo-------o|--BT-B?--B--X----oM-E-M--|E-EMXE---B--|-?oT--X---?|-?o-|BT--TE-B-|oB--?--MT|X?o-B?X-?--?X-B-T--o-B--T--B|oX--XXEo-X-oE
??--E-|--?EM-|BTT--?M-oEo|---o--BoE?----|EE--|EX-T--T-M?M?-TX-X---XEM--EMM-MEX?--B--T-|E-TT-?Mo-X?--oX--T-o?T?--|------?|-?--M----E??---?EoME-oX-E--o-|-o------?--|---?XET-|-X|XT-MB-B-EE-E-|---Xo--B-MT
o?|-EME--?-|M--?---?E-B--E?---Eo-oBMEB-?TMXT?MT--|E-M-?M-MB----T--EE-B?|ooEX--oXM---XE---oEX?---|B--B----o--EoET-E--M-o---EoB---E---oB?X-T--|--o-Xo|TMMBBT-BX-?o?MEE--BTBE--X---?-M-E--?X??-T-T-o||Mo-o-
E---X--?-T|TM?X----T---X-EE-|-----B--?X--?-BB-X-M?-o?-E|--E--M--B---T-T--X----XB----XTM--BBo?-B-TTB?B-M-?oB--X|--BB?BE--oTM-oEMX-B-?X|X-----oM|-T--?--BTo||---oXoEE-T-T-EXE------TTo---T||Mo?MMXX?--|ETv
T--|-X--E--M-E---o|--Xo-X--?-|XXo-?--??B|M|TT---??-o-T-o---BBEBoX---TB--?----?E---?E-X-|-X-B?X|EBX-o-o--?MTXEM--E-M-TT?B?B-o-----?|B|?-B-----??MT--TBo-BMEBMT--E---|-BE-?B--MEX-|?-T?B|-oB?T-?o?-T-M?-oM
TE|--M-oXT-o-T-|--B----|X--Bo??-E|XT---B|XX-|o---MB|E--ToE--TT------T-XBo-T--|X|-|T-EX|----|oo-X---TX--|o?M--Eo|--TE|BT|--TX------XT----?-X|--XEXMM---BoT?---T?-o-|-T-E----?B--E-----BB--|T--T?--X-M-?-B
---?-E?ToTE|-TE--o-EoT-?To--T?M-T|TE--EBo---ME-E?X--oEM-|E||--?T---|M?B-?B-?M?-?B-?-B-B--M-T???M-oB-X-X-XB--M-o-?-|XBEM-MT---o---|---o-|--E-?X|Mo-|X--B-B--Mo?T--?Bo?M---EX-o-BM-XT?X-T---M|M-|oM|?BE--T
E|E?-E-T-?-MBM-X|EX-E--E-|Bo-Eo?-?-?X--X-o-|-MXMT--X?|---T--B?|||-T--||-?M?|TE---MoB?---EB-----T?-M---EX-?B---B--E-T|-|--TTXBX-XM--o--oo?MoMo?-B-E|-?-XM??|--T-?-|XEE-----X?o--B-EMT--BMTM--?-?--XET---?
M-XB--ME|ME-T|XTXX|T--E--X?Xo--XT-----X-BB-B-B-?-M-------|--BX---BE-----o--EE-?-|TB-----MM----o--Xo-----?-B-B--B||-X-oBM-oBMTBTE?o---oBXX?-X---?-||----o-|--M|XB--|M--X---|o-----|----X--?-Eo|o-----?--?
EXM?XBEB|XoXTo--o-?-EEo---BME-||ToE?XEX--XB-|-T-|TXMBMT??B|B-M----|-?--|--T?-M|-o|TT?-M-----|MT-X?oM---B||-M----T??-XB|-?XT--E-----BTXX--XM|X-|-?||X-B-E|MT-T?--T--oEX|-X--?-TMX-BX--BM--M?-T|BTE-X-XB--
mE-?-M-MEM--M-B-M-|--M?-MT----o--M--XT?|X-T-?MEB-ETX---BMoBT-E-XX-EMX-E--?--Mo-BT-----|-TT----E--o||oE-|-BM-E-?--o-M-TT-|--|o-----E-B---TXBEo-TT-X-T?--?-B-|Eo--B|--o---B-?B|--MM-MM|MTT?-M--oT?E---?M-E
XXXXXXXXXXXXXXXXXXXXXXXXXXXXXXXXXXXXXXXXXXXXXXXXXXXXXXXXXXXXXXXXXXXXXXXXXXXXXXXXXXXXXXXXXXXXXXXXXXXXXXXXXXXXXXXXXXXXXXXXXXXXXXXXXXXXXXXXXXXXXXXXXXXXXXXXXXXXXXXXXXXXXXXXXXXXXXXXXXXXXXXXXXXXXXXXXXXXXXXX
