--------------------------------------------------------------------------------------------------------------------------------------------------------------------------------------------------------
---------o-------------?---o----------------?---------------------------E-------------------------------------------------------?--------------------------------------------------------------------E--
----------------------------------------------------------------------?----?----?--------------?---------------------------------------?--------------------------------------o-------------------------
--o----o-------------------------------------------------------------------------------?-----?------------------------o---------------------------------------------------------------------------------
----?----------------------------------------------------------------------------------------------E-----------------------------------------?-----o-----------E-----------?----------------------------
-------------------------?-----------------------------------------------------------------------------------------------------------------------------------------------------------------?------------
-----------------------------------------------------------------------------------------------------------------------------------------------------------------E--------o-----------------------------
------------------------------------------o-------?-------------------------------------------------------------------E---------------------------------E--------?-------------?----?------------------v
-----------------------------------------E-----------------------------o--------------------------------------o---------------------o----------------------------------------?---------E-------------X--
-----?--o-?-E---------?--o-?---E-o?--o--?--?-----?------oE-------------E----o---?oE?----E----?---------o-----?------E---------o-?-o---------?-----?--------o---?----?-E-------------?E-------?------X---
-E------E?-?----?----?---------------?--??--------?-----?---------------?--o----o---?--o-----??-E----------E-----E??-?-o-------?--E-------oo--?--------?---o?Eo---------?-----------o----o-----------XX-
-o?--?--------?------E------------?----------?-o-E-E-------------o---o-------?-------------E------o-E---------??---?-?-E--------?--E-------------------------?----------------E--??--?--------o---E--oX-
----?--?--?---------?---------o----?-?-o--E----------------E-o-----?-o---T--?-------?-------o----------?-----?E?------oo---E--o-----?o--?---E-------?---E------------?--o-?o?--------?---------------oX-
--------?-----??-----E-----?----?X---------------?---?------o---To----------oET-----E----E------T---T-----?To-E?E-?----o-------oT-E--T-o----T----ETo--?---oT----------o--?---TT--??--?--?----?-?-----X--
m-?-X------E-----X-o---E--?-o----X---X-o----?---?-----?-?----?--|--|---X---E-o|-E-o--?----?-XX--|--XX---E-E|-|-|----?---?--E----|?|--|--X---|---EE|----X---|-----------oo--?-||X?o-|---X--?o?----E--??X-
XXXXXXXX-XXXX-XXXXXX-XXXXXXXXXXXXX-XXXXXXX-XX-XXXXXXXXXXXXXXXXXX-XXXXXXX-XXXXXXXXXXXXXXoXXXXX?XXXXXXXXXXXXXX-XX-XXXXXXX-XX-XXXXXXXXXXXX-XX?-X-XXX-XXXXX---XXXXXXXXXXXXXXXXXXXXXXXXX-XX-XXXXXXX-XXXEXX--X
