--------------------------------------------------------------------------------------------------------------------------------------------------------------------------------------------------------
-----?----o-------------?-M------------------------------------------------------------------E--------------------?-------------------------o-------------------------------M---------------------------
--------------------------------------------------------------?-----------------------------------------?-M--B---------------------------------------------E--------------------------------------B-----
----------------------------------B-----------E--M--------------B--------------------o-M------M--------------M---------------------------------------B-------------o------------------------------------
----------------------------------------------------------------------------B-----------------B-----B------------?----------------M---------------------------------------------------------------------
---------------------------?--------M--o--------?----o-------M----------o------M--------------------------------------E----------------------------------------------------?----------------------------
---------E----------?-------------------------------------?------------------------B-----M-----------------------------o------------------------------------------------E----------------------B--M-----
--------------------?--o--M-----------------------------------------------------------------?---------------------------------------E--B-----------------------------------------------------?---------v
------------------------------------------o-------------------------------------------------------------------------------------M----------E--------M---o-----------------------------------------------
-B-B--?-------M-------B----------E-----------B--X---B------E----o-o----M----B-----B?-M-M----B---------X---M-M--?-E---M--M-----?-----o--BEB-M--o-MX-o--E---E-B------B-BB--?--?--o-BB-----oB----o---o--M--
---o?-----EM--E----------oM-E-Xo--o-----E----E--X-X----?E------------?----o--------M-o-------M-o--E--XEE--oB-EM---------o-----o--B?----?--o--B---X--?o--------M------------?----ME---M-------------EE---
-----o-----B-B--??B------o---X-?-ME-E-?----E----XX---B-----------------o-B----o----M--E-----?-------?XEE?----MB-----------------?-------E-E-?-EMX-M-?-o-----B---B-E----Eo?----B--EB--EE?-----Bo--B------
--MM--?B-?-?--B--?-o?-M---?E-----B-oo-E-XE--?--EXXE------M??----M--Mo----BEMXB-B---X--EE--o?-EM-----X----o--XoEE---o--B-----------?--M---------X?----------BM-B?--XX-BoEo-B-B-EMX----oE---BM-XM---------
-----E---Bo-M----BEBE-???--X-?-----MEo--X-?XB----XMo-X---E--M-M---oB---------------XE--------------X--BB-----?X-o-M----Eo-o---X-B-E------?--XoX-X-----------------EXXX-BM---TXX-X--M--E--M-X-X-----XM---
mB-?|------?|B-EXE|X--XXo?E-XXo-EEMEX--XX-?oX----X--X--MXXoM-------XB---E-E-MX-X--BX-EBB-X---E-X--?BXo-----X--oX-XM---XX--XX|XXX---BMB------EX-X|M-X--B---XX--X-XEXXX---E-EB|EXEXX-X-X-----BX-M-X?oXo?--
XXXXXXXXXXXXXXXXXXXXXXXXXXXXXXXXXXXXXXXXXXXXXXXXXXXXXXXXXXXXXXXXXXXXXXXXXXXXXXXXXXXXXXXXXXXXXXXXXXXXXXXXXXXXXXXXXXXXXXXXXXXXXXXXXXXXXXXXXXXXXXXXXXXXXXXXXXXXXXXXXXXXXXXXXXXXXXXXXXXXXXXXXXXXXXXXXXXXXXXX
