o--------?----------------------------------------------o-------------------------------------------------------------------------------------------------------------------------------------------?--|
?---------------------------------------?--?---------------------------------------------E---E-----o------------------------o--------------------------?-----------------------?-----------------?-----o
X?----------------------------------?-----------------o----?---------?---------------------------------------------------------------------------------------------------?--------?--------------------E
|-----------------------?---------------------------?-----------------------------------------------------------------------------------------------?-----------------------------------E----o---------M
?--------------------------------------?---------------?-----------------------------------------------------?-----------------------------------?-----------------------------------------------------M
--------------------------------------------E--------------------?--------------------------------------------------------------------------------?------?------?--E---------------------------------o-?
X-----E-------------------o----?----------------------------?-----------------------------------------------E------------------------------------------------------------------------------------------T
|------------o--------------------------------?E-------E------------------?-o----------------o--o------------------------?------------------------------------------------------o------------------o--Xv
E?-------------------------?-------------------------------------------?------------------------------------------E--------------------------------------o---------------------------------------------X
E--------------------------------------------------------------------------------------------------------------------------------------------------?------------------------------------o--------------B
-----??-----------------------------------?--------------------------------------------------------------------o--------------------------E----------------------------E-------------------o-o-?-------M
o----------------------------------------?---------------------o-------------------------------------------------------------------------------------------------?--------------------------?----------E
-------------------------------------------------------o--------------------?-?-------------------------------------------------------------------------?----------------------------------------------E
E--------------?---------------------------------------------------------o-----------------------------?----E--------------------?-----------------------------------------------------E---------------M
m-----------------------?--------X----------------o-----------X-------------X-----------------------------------------?--?---------------X-X-X-X--?----------------------X------------o--------X---?---B
XXXXXXXXXXXXXXXXXXXXXXXXXXXXXXXXXXXXXXXXXXXXXXXXXXXXXXXXXXXXXXXXXXXXXXXXXXXXXXXXXXXXXXXXXXXXXXXXXXXXXXXXXXXXXXXXXXXXXXXXXXXXXXXXXXXXXXXXXXXXXXXXXXXXXXXXXXXXXXXXXXXXXXXXXXXXXXXXXXXXXXXXXXXXXXXXXXXXXXXX
