---?---E-T-Xo-?-T?--M---?|o-|-B-|T||--EX-B-?--EM-E------X-B----X---E--XT-M--o?o-|------?-ME--?-E--T---o--|--B---E---o---X-o----oBo---T--E-BBX-----?---|?-E?o--MX--M---------|?-BM---MBB|--?----oX-T-----
-B--Eo-----|X-?--TM--|-|-T--M?-MBXM-E---M-----T----X--X--B-|X--------------T-TXBX-Mo-MBMX--T-ET-B-E-|-X---XM-T---|o-M?-----B--o?-T-|X-?--?-Mo-TE|M----XEo---?MoEo--|-oM------o-Mo-EoMXo--|o----MX-MMX---
-|Mo--|B|MM-o-M----MoTo-B-o-|--?EX--MX--B--oE---ET-M--M-T-|-|-----M---E--X---B-M-ME-MBT---T|-MB-----X--E-M-XM-o--oX-----XB-o--TE-?B--T-B-o---o--T|----E---TE--E-TE?--M-XB?|o-M---T--M---------|-ooE-TET-
--?---T--E-------|-M-----XXB-X?-E-----E--T--E----T--o?Bo-M----------oM--EB---B--?-T-T?---EE---|T|-|-MEX|o--o|-E--|ET------o--o--|T-|XT-o|M-M--BXXo?E|--M-B|E?o----B|B-XX|-X?--o--M-ME-?---M-M------?----
-BTX--o----X|o---X?-E-|-||oEo--To|--XB|---M----B-oX-?B-BB-T---?E--?---T--M---oT|MXTo---X--EX?-M--MXBB-T-?T-?--?--o-oE-M-X-----B-Xo--X-BX--o-MoT-|-X----E--E-E-E-EE-oE-------------?B-|XETX-B----|---B---
--?T-M--B-M-X-MX----XM----|M-|??---?-B-X--X??BM--X|X-EXBE-|--X-X---T----M----XEE-----X-----M-M-MM---XBooB--EB?--TM?-o-|oTE--o--B-?-----T------oMoE|M-o--o-?T|-T-B|E---?T|-?X--|--?E-?M?B--|X-T--o|--o|--
----BMMMB--------|-E-o-|?---TT--MT-TB-MM-|EE----X---X-M-E|--E|------|oT-MXME?|-?---E--M|BBo--M--M---------o-T-X---o--------M-|o-TBMoT|-E-----o------M?-E-E|?--M-E--M---M--o--|TE-XM--o-E-----X--T----?--
---|?---X-ooE-|---o---oM---EX?--o-T|M---oo-MoM--BE-X-|-E-----XMEo--X-TMT--M-|-----|----X|?-MM-??-oB-X--T|oE|----|-?M|--oT-XT---E-?-M---?-ME--TE|--TM--|XB----|M-B--T----MX---T|E----o---X|---|----?-o--v
-Mo----E----M-MM-----?--EoBM--E----------o--T---o-X-?T-X?--M?----T----o-Bo----M------o--XM-M-E-|---B--X-----X--?B--|?-oE-ETMo-T|B--XME-EM-oBoB?o-MMMM--?--B--|-ooo----o---o-?MEB?--M-M--oXBX--X----o-M-f
---TT-oT|-|-T--|oB--BX-----o-B--E--M-B-o-B-|MXXE--X?-MTB--T---?X----|-?-----o---BB-oMo---|-----X?|E-E---------oTE-E---B-----MM?BET|T-T-?oB-EX-E----E??---B--o--|-oE???--B|--B?---?|--o-?|o?---o-E---EM-f
---B-Xo----------To-|---X-TT-TM--oB---X-E--?-?--?EB--M----T---E-T-MM-|---B-EoE-------?--XB-------o|---------T--E--??|MMX|--?EB---B-X----o--E-TEX-----M?M-TX-----EME?B---E-?----oo--E-X--M--X-?X--o-----f
-XTM-MM-|BX---T----X---BB---BX-EX|-ooX|oT--E|--M------E--TE--oo---|--M---EB---B--?-M---B-|?-|-o--T-|X-EX-?---X?E----ME-|----B---?-TME-?-------X-M|--|-X|--M?-|TX--|---BB--XoXTo---X--B|------?-M?|o----f
-|BE-X--M--M-oo-|-BBMo-|---TM----B--?|---EBT-oXo-oT-----Mo|T-|o--o?------oM-E----o--T-M-B-oB-B--T-M-B-X-T--T-----T---X----E--MX--BEB-----B--T--o-T------XB-XE?|TX-E?|?-|-|--?X---------EME---BBT--XX---f
--o?BT-----Mo---TB-?E--E---M-T?X--------T-----B-----EX-BX?-ME-----X-BT|--X--|E--MX|ooBB--B-B---?--M--|T-EMX|--E|-MMoMMT-MET-----B----|M---B---X--BB-?-?M-||-X-------M--T?-o--?-E-oE---T|M---M-B-MT-M---f
m|?-M--E-?E-|E-X---EXo-X-BT-M-M-??-TX-TB---X--B?-E---X-M|-BXX----M---|-BM-BoB-M-TM--o--M--T-X|--o-o?--TX|--|T?-MB-MBEE-E-Xo-?--|ooM?----o--?T---o----M--M?--TT||XoMT--|o-?-?-?-MXE---B---BB-?-XBo-?X--?X
XXXXXXXXXXXXXXXXXXXXXXXXXXXXXXXXXXXXXXXXXXXXXXXXXXXXXXXXXXXXXXXXXXXXXXXXXXXXXXXXXXXXXXXXXXXXXXXXXXXXXXXXXXXXXXXXXXXXXXXXXXXXXXXXXXXXXXXXXXXXXXXXXXXXXXXXXXXXXXXXXXXXXXXXXXXXXXXXXXXXXXXXXXXXXXXXXXXXXXXX
