-------------------o-?-----------------------------------------------------------------------------------------E-----------?---------------------------------?---E------------o-------------------E-----
-----------------------------------------------------------------------------------------------------------------------E---------------------------------?----------------------------------------------
-------------?-----------------------?-------?-----------------------------------------E-----------------------------------------------------------------------------------o---?----?-------------------
-------------------------------------?------------------------------------------------------------------?---------?--------E----------------------?-----------------------------------------------------
--------------------------------------------------------------------------------------------E-------------?---------------------------------------?-------------------------------o---------------------
-------------------------------------E-----------E------------------?E--?--?-------------------E---------o---------------------------------------------E------------------------------------------------
--------------------------------E----------------?------------------------------------------------------------?-------------------------------------o-----------------------------------------E---------
---------------?----------o----------------------o-----------------------------------------------------------------------------------------------?-----------------------------------------------------v
------------------------?-----------------------?----o------------------------------------------------------------------------------------------------------------E------?-------------?---------------f
-----------?----------------------------------------------E-----------------------E------------o---------E---E?-------------------------------E-----------------?--------------------------------------f
-----------------------------------------?------------o--------o------------------------------o-----------------------------o-----------------E----??---------------------------?----------------E-----f
--------------------------------------------------------------------------------------------------E---?--?---------------------------?--------------------?----------------------?---------------------f
------?-----------------------------------------------------?-------------------E----------E---------------------------------------E---------------------------------------------E---------------------f
-----------------------------------------------------------------------------------------------------------------------------------------------------o-------------------------------------?-----------f
mo----------------------E------------X-----X---------------------o---------------X?X---------X-------------X----------------X-----------X---Xo--X--X----?------X-------X----X---X-----------------X----X
XXXXXXXXXXXXXXXXXXXXXXXXXXXXXXXXXXXXXXXXXXXXXXXXXXXXXXXXXXXXXXXXXXXXXXXXXXXXXXXXXXXXXXXXXXXXXXXXXXXXXXXXXXXXXXXXXXXXXXXXXXXXXXXXXXXXXXXXXXXXXXXXXXXXXXXXXXXXXXXXXXXXXXXXXXXXXXXXXXXXXXXXXXXXXXXXXXXXXXXX
