---?-----?-------------------?------EE----------------------o--------------------------------------------------?-----------------?-------E---------------------------o-?---------------------------?----
-----------------------------------------------------------------o----------??-------------------------------------E------------------------------------------oE--------o-------o-----------------------
--o-----o--------------------------E----------o--------------------------------------------?-?---------o-----------------?----?-----------------?-------------------------------------o-----------------
---------------?---------o----------------------------E----------------------?--------?------------------------------------------------------------------------------?-----------------?----------------
--?--E---?-------E----------------------------o-o-------E----?-?-----------o--------------------?-------------------------------o-------------------------------?E---------------?-----------------E--?-
-----------?E---oE---?--o---------------?---------------------------------?---E-------------o--------------?E-----------------------o?o-------------?-o--E---------------?-----------------------?------
--------------?---------------------------E------------------------------------?------------?-------------------?-----E------------------------------------------E---------------?----------------?-----
---------o-------------?--------------------------------------------------E----?------?-E---------------------------------?--?--------?-?------------------------------E---------E------E-----------?--v
--------------o?----E?----E-o-?-----?o-o-E--------?-------?o-o-----???--?-----?-----------o?E-------E------o----------?-?-o---E---o--?----------E---?-----o-oE-?-?-?------------------E----?-E-------o--
-----Eo-----?--??--?--Eo--------------E---?o-----?-??-----o------------?o--E-o---?--E---E--o---------?--o---?-Eo--o----?-----------E------?--??------?---o-----E-------?----------?-------E--EE-E-------
--------o?-----------o------?---o-----------?-----??----E-----o----------?------E--Eo-?E--------o----?--?-o----------?----?---?-----------E-?---E?-----E--E--------?--------?------?--o---?----------o--
--o-?o------o--E?--------?--??-----?--------?o-----oE----?-------?--??---------oo-----?-?--??o-----------------------------?o-?E-----o--o-----E---------E---E?E?-------------?----o-------E?--o?o-------
-----?------E---?----o-----?----?----E--?-E-------E--Eo-------------------------o------?---?--?-----?--?---E?-?--?----?------------o---E--------o----E------??-----oo-----?o-------------?-----------o--
----?E-?-||??---o-?----o---Eo---o?-??-|-|---?--|-E--------------------?o-?-----?To----o----E-|-?---|o--------?--?Eo|---?-|-----?---?-----|--?---------E---?-----|--E?---o|---o---|--?-?|----T-?--?------
m?|?||--?|||?-|--||--|?|o----||||-o-|-|-||oE|o-|--|-?-||-E|-||||--?|-|?|||?|-?-||-||--|E|o?--|||||-|-o?|o?||--||||?|-o||---|?E||E|-E--||?--|-E--||-||-E|-||-|o|?||-||-|||||?-||-|||?E|?||--|||E|-||-----
XXXXXXXXXXXXXXXXXXXXXXXXXXXXXXXXXXXXXXXXXXXXXXXXXXXXXXXXXXXXXXXXXXXXXXXXXXXXXXXXXXXXXXXXXXXXXXXXXXXXXXXXXXXXXXXXXXXXXXXXXXXXXXXXXXXXXXXXXXXXXXXXXXXXXXXXXXXXXXXXXXXXXXXXXXXXXXXXXXXXXXXXXXXXXXXXXXXXXXXX
