---E--?----?-------------------------------------------???------------------?-----------------o---------------------------------------------------------------------------------------------------------
--------------------o---------------------------------------?------------------------------??--?------?---------------o--------------------------o-----------------E------------------------------------
---------------?--------------o--------o-E------------------------------?-------------------------------E--------------------E-??---------------------------E-----?----------------------E--------------
-------------?--------------------------------------------------------------------------------------E---E---------------------------------------------------------------E-------------------------------
------------------------------------------------?--------?-----------------------------------o----------------------------------------------------------------------------------------------------------
--?-------------------------------E-----------------------------------------------?---------------?------------------------------------?----------------------------------------------------------------
-------------------------------------------------------------------------------------------------------------------------------------o-----?----------------o----------?--------------------------------
---------------------------------?---o----------------------------------E------------------------------------E------------o----------------------------?------------?------E---------------------------v
------------------------------------------------------------------------?-----------------------------------------E-----------------------------?----------------------o------?------------------------f
---------------------o-----------------------------?-E-----------------------?------E------------------------?---------------?-----?---------------------o---------------------------E-----------------f
-------------------------------------------------?-------------------------------------------------------------E---------------------------------------------------------------------------------------f
----o-----------------------------------------------------------o------------------?--o--------------?---------------------?--------------------------------------?-----------------?-o------E--------Ef
---------------------------------------------------------------------------------------------------------o-----------------------?-------------------------------------E------------------------?------f
--------------?--------------------E-------------------------------------------o----------------------------------------E--------------------------------?o------E-------------------------------------f
m|------------------------------------E--|----|-----?------?-----------o--|-----------|---|-E----||------------------------|--?-----------|-------------|---------|-----?----------------------------|-X
XXXXXXXXXXXXXXXXXXXXXXXXXXXXXXXXXXXXXXXXXXXXXXXXXXXXXXXXXXXXXXXXXXXXXXXXXXXXXXXXXXXXXXXXXXXXXXXXXXXXXXXXXXXXXXXXXXXXXXXXXXXXXXXXXXXXXXXXXXXXXXXXXXXXXXXXXXXXXXXXXXXXXXXXXXXXXXXXXXXXXXXXXXXXXXXXXXXXXXXX
