--------------------------------------------------------------------------------------------------------------------------------------------------------------------------------------------------------
--------------------------------------------------------------------------------------------------------------------------------------------------------------------------------------------------------
--------------------------------------------------------------------------------------------------------------------------------------------------------------------------------------------------------
--------------------------------------------------------------------------------------------------------------------------------------------------------------------------------------------------------
--------------------------------------------------------------------------------------------------------------------------------------------------------------------------------------------------------
--------------------------------------------------------------------------------------------------------------------------------------------------------------------------------------------------------
--------------------------------------------------------------------------------------------------------------------------------------------------------------------------------------------------------
-------------------------------------------------------------------------------------------------------------------------------------------------------------------------------------------------------v
---o-??----o-o?-E-o?----?---?----------?--------?-?---------?------?--------?--?-----E-?------E----E?---E?-E-?--?-----?-----------?--?E--?-------E---?---?------------Eo-?E-------E--------------?E-----
-------E----E-----?-?--------?---o---o---oE----------o-----o------?------E------?---E------------------E----o-------?-----E----E-E----------o---o---?---?----?--?--o------o--?-o-----?-----?------E-----
-----o----?-----?-------------EE------E-E-?o-?-------------?------------o----?o-o------------o--E---------o----?-----?-------E---?--?--??-----?--o-------E---?--?-??---o---??---------------------------
-E---o---?o-??-----?------------?-----------o----o--?---------?--o-??-E-----o?-E--?-o-E--?E--o---??-o----------------??-------?----?---------------?---E-?---?-?---------------o---E-oE-?-o---oE--?-o---
---E-E--?-E--?---------------?--o-?--E----?------o-------?---------------?--------E----E-E---E--------?------EE-------------------------o------?---E---?---o-o----------?-------E------E---E--o-------?-
---o?-------o---?-----------E---?-?--E---o-----?-----o?------E--------o----E?----------o--oo-----o----?--E------------o---o--?-?--E------?----E-----o-?EE--?---E----?-----?-----------------------?--?--
m--X|X---X--X-X?---|X--X---E--E-X-X-|X|-E|XE-|oEXX-X-EX|--|EXo----|X-o|E-o-X--X-?----X-X|-----X?X-oE-E-X--XXX-?o-----o||X|-?-----E?--|oXE-XXX-?--XXX--XXXE-o-o?-||E?X|--X--X-??---X|??--XX|X--XX--X---X-
XXXXXXXXXXXXXXXXXXXXXXXXXXXXXXXXXXXXXXXXXXXXXXXXXXXXXXXXXXXXXXXXXXXXXXXXXXXXXXXXXXXXXXXXXXXXXXXXXXXXXXXXXXXXXXXXXXXXXXXXXXXXXXXXXXXXXXXXXXXXXXXXXXXXXXXXXXXXXXXXXXXXXXXXXXXXXXXXXXXXXXXXXXXXXXXXXXXXXXXX
