--------------------------------------------------------------------------------------------------------------------------------------------------------------------------------------------------------
--------------------------------------------------------------------------------------------------------------------------------------------------------------------------------------------------------
--------------------------------------------------------------------------------------------------------------------------------------------------------------------------------------------------------
--------------------------------------------------------------------------------------------------------------------------------------------------------------------------------------------------------
--------------------------------------------------------------------------------------------------------------------------------------------------------------------------------------------------------
--------------------------------------------------------------------------------------------------------------------------------------------------------------------------------------------------------
--------------------------------------------------------------------------------------------------------------------------------------------------------------------------------------------------------
-------------------------------------------------------------------------------------------------------------------------------------------------------------------------------------------------------v
--------------------------------------------------------------------------------------------------------------------------------------------------------------------------------------------------------
-E---?o?--?EXE-X---Eo-----?X------------?-----X-?XX?--X-Xo-----o--o---?--------?-E?-----o?----X-X-EX----o---------X---?-oX---Eo-o---XX-X---oXoX----------??-X?--?oX-??o--------oX??--o?---------??XEX?--
--??-o?---XXX---XXX--------X?-XX-X-?----------X-XX?-o-?XXE------?---------?--E--E----o--------?X-XoX-E---o---o?--X-ooX--EX-??--------XX-?----X---o----Eo--XX?----XE?-??---------X-----?---?------XXoEX--
--X?X?---oXX-----X----o----XXX--X-----?----o--X?XE----X-XE?----E?------o---??----------?--oE---X-X-X-XE-?----?--XXX?X--?--XXX------XX?X----Xo-X--X?--------XE--XXXX---XE??---o?X------o-------o---X--X--
---X?X----X-XE---XX-------E-X?XX--?-?--?-E-XX-XX------?X----E-?oXE------------?---?-----E---E-X-X?-XX--------?--XXo-X-XX---X------XX-X?-----XX-o--XX-----oE-X---XX----XX-E----X----o------oo-E-----XXX--
-o--XXE-oXX-X-X?-X----?--E-o?XXXXX?X??-E----X-X--oE?X-X---E?X-XXX-E-------oX?E---?X?X--EoXXEX?oX-EoXXE-E-?-oo-X--XXX?X--X---X--?--XXXXXXXEXXX-?X--EX-----EXX---?X--?---XEo--XX--E-o-X-oX---X--o--X-XX---
m-X-XX-?-X--X-X--X----oX--E-?-X-XXXX----E?XEXX--?-?--XE---Xo-X--X-?-XXXoXX--X-XX?X?XX?o--X-X--X-??X-?XX--o-XXX-XX-?XX--XX-X-X-X--XEXXXX-oX-X?-X--o--Xo-o---XX--XX---XXE-X-E-X----XXX-XX--oE-X--E-?XXX?--
XXXXXXXXXXXXXXXXXXXXXXXXXXXXXXXXXXXXXXXXXXXXXXXXXXXXXXXXXXXXXXXXXXXXXXXXXXXXXXXXXXXXXXXXXXXXXXXXXXXXXXXXXXXXXXXXXXXXXXXXXXXXXXXXXXXXXXXXXXXXXXXXXXXXXXXXXXXXXXXXXXXXXXXXXXXXXXXXXXXXXXXXXXXXXXXXXXXXXXXX
