--------------------------------------------------------------------------------------------------------------------------------------------------------------------------------------------------------
--------------------------------------------------------------------------------------------------------------------------------------------------------------------------------------------------------
--------------------------------------------------------------------------------------------------------------------------------------------------------------------------------------------------------
--------------------------------------------------------------------------------------------------------------------------------------------------------------------------------------------------------
--------------------------------------------------------------------------------------------------------------------------------------------------------------------------------------------------------
--------------------------------------------------------------------------------------------------------------------------------------------------------------------------------------------------------
--------------------------------------------------------------------------------------------------------------------------------------------------------------------------------------------------------
-------------------------------------------------------------------------------------------------------------------------------------------------------------------------------------------------------v
-----EE?--E-----E---------?-------?-------?--E-E--o-?---?E--o??E?-------E------?-------?----------?---?-o----E---------o?-?-?--------?-o----?--------------oE------?--o---?---------o--o-?-?--o?--------
---o-------o---------E-------?------------------o-?-----o---?o-----E?-----?---?--o--?-------o--oE-?------E-?----?----o?------E-----oo?------------?--------o?---E----E-EE---E------------?---?------?---
--o-oE--------o--?-?-?-?----o---o----?-??--o-?--------o--E---------?-E-------?---------------E---?------E-----Eo---------E---E-----------------E---E---------E--E-----------?---?---E-?-----------------
-------o---E---?-?----?----------------?---------E----Eo----?-E------Eoo--??---------------?-?E-o---?-----E--------E--E?---------E-----?-----E-o-EE--E---------E--o----------------?-----?-E?-----E-----
-E?---?E--------?-------?--?--o----oo-?o-----?----EE--E-?--oE-?------?----------o------?------?-E--------E----E-?--------o?----?------o-?E---o------E-o------?---?---o?----?---?-----??-?-----o-?-----?-
----E----o-E-?-------E--------E------o-----?--o-o---oo--EEE-?---o-?-----------?----E----?-------o--------------------?-E---o?-?----------E-----------o-o-E-------E---E----?--E------?-o---o----?---o----
m---?XXXX--|??X--X-?-EE-X-X---E--X-X?----?|XXX|-XX-E-?-X--E-Xo?o---?-o-XX----Xo-X-|o-E-XX-?X--E|-|--X-X--?XXX--Xo|?-o---XX-|----??E|-X--o--XXX---?EX-X?--|oX-----Xo--X-X?-o-XX-XXo|-|X-XX-X-XXX--?-|--X-
XXXXXXXXXXXXXXXXXXXXXXXXXXXXXXXXXXXXXXXXXXXXXXXXXXXXXXXXXXXXXXXXXXXXXXXXXXXXXXXXXXXXXXXXXXXXXXXXXXXXXXXXXXXXXXXXXXXXXXXXXXXXXXXXXXXXXXXXXXXXXXXXXXXXXXXXXXXXXXXXXXXXXXXXXXXXXXXXXXXXXXXXXXXXXXXXXXXXXXXX
