--------------------------------------------------------------------------------------------------------------------------------------------------------------------------------------------------------
--------------------------------------------------------------------------------------------------------------------------------------------------------------------------------------------------------
--------------------------------------------------------------------------------------------------------------------------------------------------------------------------------------------------------
--------------------------------------------------------------------------------------------------------------------------------------------------------------------------------------------------------
--------------------------------------------------------------------------------------------------------------------------------------------------------------------------------------------------------
--------------------------------------------------------------------------------------------------------------------------------------------------------------------------------------------------------
--------------------------------------------------------------------------------------------------------------------------------------------------------------------------------------------------------
-------------------------------------------------------------------------------------------------------------------------------------------------------------------------------------------------------v
-?-------------E--?o---?-----------?E-E---?------?-----o--E-E---oooo??o--?------oo-o---?---?o-----o----?--o-----------o-----?o-E------?--?----?--------?-o---------?---------?-------o--?--------?--?---
-------?------E-?-------?-E----?-EE-?---o---E----E--o?-?--?--E---???----oo-E---?------?--E-------o-o?-?-o-------o---E-?--E---o--?------?----??--E-------?-------E-------o--E---?----?--E--E----?--?-----
-?----??--?---?--------E---?--o---Eo-?--?------------E?-o----?--?------?-----?-------E--?-------?---------??----?--?--o-------oE-o------E------------E--????---??-?------?------o----?--?-----?---?---?-
----E--o-------Eo---E----Eo------------?-?--?-?-??o---?-------?--o-E--------?---E?o--E-??-o---?----o--------E--o------??-o---?--?-----o-------oo------o--E?----E------?-----?E--oo?----------?--o--?----
------?------?----???-?-------?-E-?------?-o--o----o------?------------------------------------------------EE-E-EE-oo--------??-----E-o------?----?-------------?-----o--???oo--oE---?----?--?-------?--
-------?---------?--E------E?--EE--?--?-E-o-o--------?-?-?-----?----------E------?-o---E-?------E---------E----------------------o-o-------?-----------?--E---?----?--------E--E------o----E-------o----
m-|-X-|XooX----XX|o-X|X|-o|XX--X|X-oXX-X??-X-o------XoXo-X-o-??-XXX-X|-?X-X--X|XX|-?oE-?|X|XE|-X--XX-Xo|--|XX-X-X--o?X---XX-X-|-|XX-X-XXXX-o--XXX--XXX-E--EX-?--o?----X-----X-X||-Xo-E--?EXXE--EX-o--|--
XXXXXXXXXXXXXXXXXXXXXXXXXXXXXXXXXXXXXXXXXXXXXXXXXXXXXXXXXXXXXXXXXXXXXXXXXXXXXXXXXXXXXXXXXXXXXXXXXXXXXXXXXXXXXXXXXXXXXXXXXXXXXXXXXXXXXXXXXXXXXXXXXXXXXXXXXXXXXXXXXXXXXXXXXXXXXXXXXXXXXXXXXXXXXXXXXXXXXXXX
