-----------------?--------------?------------?-----------------------------?----------------------------------------------------------------------------------------------?--o--E-----------------------
----------------------------------------------------------------------------------------------E------?------------------------------------------?-------------------------------------------------------
---------------------------------E------------------------------?------------------------------------------------------?----------------------o---------E----------------------------?------------------
-?---------------------------------o-E--------------------------------------------E--------------------------------------------------------?---------o--------------------------------------------------
-----------------------------------------------?-------------?-----------------------------------------------------------------?-------------?--?-------------------------------------------------------
---?------------------------------------------------o------?------o-----------?-----------------------------------------------------------------------------------------?---------------o---------------
-------------------------------------------------o?o-------------------------------------?--------------------?--o---------------------o----------------------------------------------------------------
-----------------------------------------------------------o-----------------------------------------------------------------------------------------?-------------------------------------------E-----v
----------------------o---------E------------------------------------------------------------------------------------?-------------------------?-----------?-------------------------------------------f
----------------E---------o-------------------?-----------------E------------------------------------------------?------------------------------------------------?--------------------o-------------?-f
----E---------------------------------------------------------------------------?-----------------?--------------------?--------------------o----------------------------------------------------------f
-------------------------------------------------------o---------------------------------------------------------------------------------------?---------------------------------------E-?-------------f
---------------?--------------------------------------------------------------------------------------o-------------------------------E------------------o---?-----------------------------------------f
--------------------------------?------------?-----o------------------------------o--------------------------E--------------------?------------------------?-----------------------------------?-------f
m-------|--------|--E----?------?-----o|?--|--|---|-|----------|-------?---|-o---|-------------------|---------|--|o----------------o---------|-------|---------------------|--------E--o-?------------X
XXXXXXXXXXXXXXXXXXXXXXXXXXXXXXXXXXXXXXXXXXXXXXXXXXXXXXXXXXXXXXXXXXXXXXXXXXXXXXXXXXXXXXXXXXXXXXXXXXXXXXXXXXXXXXXXXXXXXXXXXXXXXXXXXXXXXXXXXXXXXXXXXXXXXXXXXXXXXXXXXXXXXXXXXXXXXXXXXXXXXXXXXXXXXXXXXXXXXXXX
