--BB----??-BB------oET----M-X----T-E------o-M----M--EXB-T-----|T-B-E|MMo----E|oE-TM----B--?oT--oXBMM---B-|----E---o--|B-X-----ooo-M-M--M|E--E-?oE-M-X--o---|BM------------o---|--?---E|-T----E---T-T-E--
----M?-M--X-|----B-?oTT-||-|-T-|E|BEoM--EB-o?E--oo-----o---E-MT|o--oMXEX?--M-XT|-BM--T-|E?M-M-?E|ToT--E--M----X-oB--o----------M?T-X---|M----|XB-X-oXT---B----oB-T-BB--|BM----oB-oB-o----M--------------
-----B-o--------E---|-ETo---|-------E--B-M--B-MTT|TXX-|--M-ETM-|-M--?-?T-T--E---?----E---oX?B-X-XM-T-----|--o-E----X-BE---------B----E----X|X-XBTM----E-?|--------M-----BT-|E--BX--EB-----M-E|--?--E-XB-
----o----T-?-----E-E--E-TB-oT-T?-M-?----MT-?-XEE-TMoo--E--|-EX|--?--|TB-EXT----Mo--|-X--------|-?|TM---MoX??-EE|T----X--E-|M??MB--||--?EM--M-ME-TX-|-M-M|-----o--E-EX--M--MM-?----|---B--X-----B-T-BMMM-
-M------|-X----B-M-E------B-oE-M----??---E-X--oX-EMBo---?--BXX-EoE----T|--BoE-----X--|---oT-------|oE?-TX-M-------M?-|----XT----B---------------o-----?B-------MX|?--|o---M-T?TB--B--o---oB-|---X-B-----
-MBX--E-oXMB---EX|?o---o---E---XE---X--E|-X-BXT-||X-XEo----|X-T-----X|---BMMo-?Bo--?XE-B-|---oT--o|--MM|M-|T-|-B--?-|--oB--E-X---B--?|EE-----------------?M--|---X---M-B??|----To----o---?-----o-|o--|--
------T--M?B-M-M?---MBT---?MXM-M-E--||M-----oXM--oB--?E-----|--T--------B-EB---XE-??X------|XoB----XMBToM-o??X--oE-ET---M-----E--X---BEMT-||T--M??Mo?E|T-|?--BB--E-M-XB|E--E|-|-Bo|-o-?--TM---B--X-|-?M-
--M|T-X-?Mo---M|--XE-M??T-?----o----|M--T|-o--X---E-X-?o-XE---T--B-T|?o?E-o?MT-M---M-?-|-M-TE----E-----?-oT--||T----E-------X--?--|-|M|B-X-?-B----M--?BB??--?---X|-M--|--|?----------B---?--?MX--o-M--?v
-MMX-E-----E--TB--|--oM--?-o-M---o?---E-----MB-B---E------MB-?-------M-|----------M-T??X--BTB-?--X-E-B--------B--?---?-----ME?-B--------E-----B---M--|---|o|------MEBo--M|o-----M---TX--B--T--|--XB-X--f
-E-oB-M-BX------o--|BT---TEB---?|E?|--M-o----XM---MTo?-B-?T----T-M---X----X---------?-||-o-Xo---Bo?----------E|--T-oTB----oB?---E-Eo-B-MB--M---M---T|-?MMTXT--E-MXM--------?o---??-X----BT------?-BMB--f
-?B--?T||----EXXX---E-E----T|--ET--X---T----?|o--E--E-M----?--E-o-|-|--E-T?|-EB--o-o-oX-?--??TMEMo--oM--EX-E-M--MX-----EM--M--B|M-----B--|-E--?Mo|-TBB----?---oT|-BM--T?------oXE------?--B|-----|---X-f
-E---T-B?-------T----T?|--Eo--?T-B---XTBEo-----XXX----MT?EM-o--?-E----B----B|----oXoM---?oo-o|---E---o--?|--T-B--X|----X-oB----|---M?-M-E-?E-o-B-M?----?--oMT--X?--B--TM--?--E-T-----?T?--M-To-|MTo|---f
-----XEE--o-o----oX-X--|X--TTBM?TT--E-X--M---|-?-|MT---Mo-?-|-o---E-M-?-E-o--B-E?----?---X|?B-B-TB-T-X------|----------X--BE--?-X||--ETM-E-X-MX?--?----ETMBXB?-MT|M---E-oMoB--o-B-----|-X--B-B--MX-----f
----|--E-BoM--X----XXT-?----|-B-|o?X----oM-B----?-oEM--BTE--B-X-T--MTBX---?|--B-XXE?-MXTT-E-|---?X--|--?-E-T-M|T-----|M-M--BMM---o---?--MM-|--T-XXX-----o-Bo-T?M|--|-|--|T-|-T---|----?-----?X----?M---f
m--M--T-----?-M-----M-o-?-??-T-MT||?---E?BT--|MX---|-?---Eo-ooXXT-----B-?----B-E-?-?-?oT------T---o-M---Eo-----E-|-MM-o-----X-----|E---T---?M??-oM--Eo-oE--EE|------M-?E-?-T-Eo-o-E---|-EXT------B--TMXX
XXXXXXXXXXXXXXXXXXXXXXXXXXXXXXXXXXXXXXXXXXXXXXXXXXXXXXXXXXXXXXXXXXXXXXXXXXXXXXXXXXXXXXXXXXXXXXXXXXXXXXXXXXXXXXXXXXXXXXXXXXXXXXXXXXXXXXXXXXXXXXXXXXXXXXXXXXXXXXXXXXXXXXXXXXXXXXXXXXXXXXXXXXXXXXXXXXXXXXXX
