---------------------------------------------?------------o---------------------------------------------------------------?-----------------------------?----------?--o---------------------------------
---------------?--------------------E------------------oE-------------------------------------E-----?----------------------------------------------------?----------------------------------------------
----------------------------?-----o------------?-----o------------------------?---------------------------------------?------------------?-------?-?--------------o-------------------------------------
-------------------------------------------------------------------------------------------------------------?---------------------E--------------o------------o---------o----o-------?-----------------
---------------------------------------E-------------------------------------------------------o-------?----------------------------------o---------E--------------------?------------?-----------------
--o-----------?----------------------------?---------?----------------------------?--------------------------?-------------------?o------?---?----?--------------?----------------------------------o---
--------------?------E-----------E------?----------o--------------------------------?---E-------------------------E---------------------?---------------------------------------------------------------
-?-------------?-o----------?-----------------?--------E---?------??-E--------------E---E---------------------------------?---------E-----------------------E------------------------------------------v
-------------------------------------------------------------------------o--------------?--------------------?----?------------------o------------?------------------?---------------------------------f
-----------------------------?----?-------------------------?-------?--------------------------------------------------------o-----------------------------E-------E------------------o?---------------f
---------o------?-------?-----------o---?---E---------------E-------------E-------o-----------------?----E------E----------------------------------?---?-----------------------------------------------f
--------------------------------------------------------------------------------E--------------------------o-------?--------------------------------------------?-------------E---------------E--------f
------------E---------------------------?----?--------------------------------------E--------?-?-----?---------------------o---o-------o-------------?-------------------------------------------------f
-------------o----------------------X---?-----------E-------------------------------E---------------------o-----------------------------------------------------------------------?-?--------?---------f
m-----------------X----|---|--------X------|----------------------------------------------X-----------------X--------?----------------|----------------------------------------------------------------X
XXXXXXXXXXXXXXXXXXXXXXXXXXXXXXXXXXXXXXXXXXXXXXXXXXXXXXXXXXXXXXXXXXXXXXXXXXXXXXXXXXXXXXXXXXXXXXXXXXXXXXXXXXXXXXXXXXXXXXXXXXXXXXXXXXXXXXXXXXXXXXXXXXXXXXXXXXXXXXXXXXXXXXXXXXXXXXXXXXXXXXXXXXXXXXXXXXXXXXXX
