M|-XM?To--oo|T--M-E-E----|-o--|-To|B|MXB-o---X||---MT-o?--XM-BTM-TXB-XBB--B-------E---MBXE--X--B--?-X--B-Bo--o?BM|-o---XB-|--|E?--|-?---X?-o---EXB?X|--o--Eo-o?-?BE||---E-T--B--|---X?--oT-M-?M?----M--T
T-B----MBM-----BE?X-|-|o-oX|-MET-MM-----|M-XTB-E-M-|XMTTX-||?|X||-BT?E-TXo--------X-o----T--oXBMT--M---oM-M-E|-o---M---BE-E-M---TM----MBB-TEEB-MXXE|------B?--|-?-?MXMT---o-E------|---o-MM-oTE-T-|T--|E
o-|oX|X-E-B-o?-oX---TB-X--EM---?-o-|---??--XT||--M-?---|-BM--?-E-?o-?|E-M---T--M?To-TTT?--M|-XE-X?-TBT-o-X---E--E---B----M|Eo-|?-X--?EXM|T--?-----X?BB-oT-MXMXM--M--|Mo--?M-?-BTo-MT-EoB?-o-B------BoMXT
--o--B?B-M----M-?--oBT-X?|?-?oB----M?E---BB?o-XTT-B----oEo--B--T-MMM?---|-MB-X---XMoT-Bo-X---o--o--|-TE-E-E-EXo--BT?-M|--E-?B-M-BM-?MEB--oEo---Eo------|X-Xo--M-B--?X---E---EX|--M-EMMEXE--TT----EBo?BXX
E-B--X-Bo|-oB-B--?--E---|B?-T-T-XBMTB-E--E-o-o-|BTTo-X---BX-oo?oo-?-?--E?-EB--B-M-|-EB--Mo--EMToTXX-XX-T---E-?-B-?E----TMBE?--o--|EEETMB--EMX-MM|-EB-E-o?T---||--?-E---E-?-|M--BXE|||X-E-X?---oBM--M--?T
E|-B?E?T|-|?-TM---B-M------?T-EoXE-T--E----TM|M--?-|?--|B--EE-o|--Eo-M--E-BB?-ETX-TBX-XE-?------XB?B||M|E|-?B-?---E|-X-oo-BB--TBXE--BX-T---E---o-XE-X---o----BXB--?---BEX-M-T-E?-T|-MM-ooEE|T---E---XoX?
-E----|Xo--E??X--X--TXM--M-MX?TX-----E--BT?-?-BMM-|---BoBEM---|M-XB---M?X----o|--?--|oE-BTo-MoBETB---X---EBo---M-?T--o---o|-?o-M-B-BE--M-T--BET-X|E?M?---X---EM--oX----?-o-MEo-B--X?-|o--oXM----B-Xo-BMB
BTEo?--X|E|X-M|||?---?-o-T-X-To--?oEB--M-XEMEM?-MBT---T-E?-o-M--E-X--ET-EBT--|o--T||TT---Mo----Bo--ET?M---T-XXT-MBE--TX---|o---------MXEB-EMXE----o---EB--T|E--?BM-TT---?-T---o--E-MB|T--|o-o-X--oE----v
E-M--EEMTXX--T-?TE---|---XMX----o-|--T-M-ETB?-o-----B|-B--MMBB--E?-XT?XMo-E-E---EoMoB-oM-M-X-T-MM---MM||--B?TX-o-B-?-o-XoET-B-X-M-XM-ToXBMEMoXMB--|--?---ME-?----?--TTXoXB-o?-B-M?-B-|---B?-?B--oX--X-XM
T--EMTo-B|X-|-E---T--TX-|--M-BoE?-|---??o|X?X-EE-o--|B?TT|?--T-?-o---o--T---X---?|-oTB-|-BM|-TEX-X-?oM?T-?-M?-|T|o?-o-?-|XE||MB-?X-T|T-M-|-?B-o-XEEM--Eo---XMoTM-oE---|XE-BB-BB---|T-oX|-X----|EX?-?-MT-
--o|-?-X|B-||-X?|-----?T---EXo-oMo-B-Eo-BT-MX-B-T-o---o--o-oB|-XBoM-TB-T--MXT-ooME--E-M-X-BM-XXTo|?M-T-BEo-XM-EM-?-EX-B-|oBB--o--oBMB-M--BT-B----B---B-MMM-oXo-B-E---|E----Eo--X-B-?M?|TT?oT-T-XE|-?--BX
?-BT?T-|oo-EEXTo----BXB-EoT-o--EXE?-?--BMoBo---TTET--T-ToTBTT-XT----ETEMoMT--TMXX|-|---o?---oXE-E-T-XBoTE-o---?X-oT-E-?MXXBBX---?TBTB|-TX-?oo-E?-B--E-MM?-?-X|?-??BX---|M--BTo--X-MEXo--o---M--|--TMTT?T
|T|-----oMMToo-MBEX--BT|XX-?---|--|---------X--E|XTBXTT--BMoMT---M--EB---BM-??XM--X----|-M-B-M-----M-MB-M-BT-XBMMMM-X-EB?--B-??X?B-|-MXE---MBM-??o?--TB-|--BT?|E------EX-?T-BE|EM--X|--B--BB-ETT-E--M--B
-----BM--Boo-|E--?EoMT?--B-|B--MM--M----o?-MB-T|-?M-?||T-XXoE-EE-oT-T|-X-?o-BXT?X----X-?B-o-To-o|---|B---B|MEBM|-?--B--B----??-T----XXE-|B----TE-ooM----X-|-M?XToMM-E---------E--X|XME---?-B-?|-?--ETX-T
m--EM-ET--oE--EEMX----||-XT-MM----|XX--M-oB-B|--|--T----M|X-|--o-T-B---o-?EXXEMXXo---MBXMB---TMTE-?|-|-B---T-To|EB-BT|EM-?T-E-?|Eo?--XTM-?B?o?--o---o--EX?-o-BXT-MM-?M??-B---oX?--o----T-E?o?Eo-EET-|-||
XXXXXXXXXXXXXXXXXXXXXXXXXXXXXXXXXXXXXXXXXXXXXXXXXXXXXXXXXXXXXXXXXXXXXXXXXXXXXXXXXXXXXXXXXXXXXXXXXXXXXXXXXXXXXXXXXXXXXXXXXXXXXXXXXXXXXXXXXXXXXXXXXXXXXXXXXXXXXXXXXXXXXXXXXXXXXXXXXXXXXXXXXXXXXXXXXXXXXXXX
