--------------------------------------------------------------------------------------------------------------------------------------------------------------------------------------------------------
---E-------------------------------o------------------------B--------------oM------------------------------------------------B------------------M----B--------o----?------------------------------------
--------B------------------------------------------------o---------------------------------------E---------------------------------------------E----------------------------------------M------?--------
------o----------------------------------------------------------o-----------------------------------------------------------------------------------E----------------------------------M---------------
----------------------o----------------------------------------------------------------------------------------------B-----------?--------------------?-------------------------------------------------
----?--------------------------------------Eo--------------E-------------------?--------------?----------------------------------------------------------BM--------------------o----------?----------M--
---------?---------------------------B---------?----------------?------------------------------------------------B--------------------------------o----------E--------M------B--------------------o-----
-------------------?---E---------------E----------?----------------------E-X----------------------------------E-------------------------------------B-------------------------------------B------------v
--------------------------o--------------X--------------?-E-----------------X--M------------------------------X---------------------------------------------------E----E--------------------------------
----o----oM?----------------o---?-??---XooXXXXXXXX-E--o?X-o---E--?-------X?X--o?--E------------------EXo-EX-X-X-----?----E-------o----?E-E?----?-M-X-?o---------??-E---?----?--?------X-X--XX----E?-----
-----?--oE--------B--------?--o----Xo?--X-X-?XXXX-?----X??---------X---?--X---X--XX-----o---?o-------XE--X-X--X-----------E-o-----?-E?--------------X-E----??ooE-----------??--------?XX---XX----?--?---
-?-o-?--EXX-oo-E--B?---------B---XX----?EXo--X-X-----?-XX?--------X-?--?--oX?X-XXoXE----------?--E----X?XXX--?X----?-X-E-------X--?-E----------o-X-?X-----------?---o---EE---?E--------X---X?------?----
-------?X--?---------E----E--Eo-oX--B??-XX----X-----?-XXoX-----?-B-X----?-EX-XX-X-X-E------------------X?X-o-XX-------X-X---o--XXX--?---?-----E---XX?-o----o-?o-o-----XX--------o-?-----XX-X---B-o---?--
---o-o?XXX?M?--?--?---E-?E-X--T--XXX-?--EX?--oXX--?-?-X-X--X--MX?-X-?-----X--XXXXX?--------------?X?-T--XX--oXoT---T--?X?X-?---TXX?----o--?-T-MTo?XoX--E-E-?XXXXEX----XXB-?------o----?E-XX-ETE?-o-B----
m?---X-X-X|-XX-XXX-X-X---XX|--|-X|X-XXE---Xo-X?X----|XX-?XoXEE-X?--XXX???X?X??X-X?|--?--E--E-E?--X-X-|?-X-M-|XX|?-o|--EX-XXEX-o|-XXXE-?-?o--|-o|X??X-XX--XoX-XX-Xo?----X-X|E-XXoE--X--X---|X?||--M---?--
XXXXXXXXXXXXXXXXXXXXXXXXXXXXXXXXXXXXXXXXXXXXXXXXXXXXXXXXXXXXXXXXXXXXXXXXXXXXXXXXXXXXXXXXXXXXXXXXXXXXXXXXXXXXXXXXXXXXXXXXXXXXXXXXXXXXXXXXXXXXXXXXXXXXXXXXXXXXXXXXXXXXXXXXXXXXXXXXXXXXXXXXXXXXXXXXXXXXXXXX
