-----E-----------------------------------E----------------------------------------?------------------E---------------------?------------------?--------E----------------?----------E--------------------
--?-----------E-------?------------E--E----?----------------E-----------------------?----E------------E----?EE------------------------------------------?----E-----??----------------E---------?--------
-?----------?--E---o-------------------------------------o-----?------------------------------?---E--E----------------------------------?-----------E-?-----o---E-------------------?--------------E----
------------------------------------------?-----------E---?------------------------E?----------------?----E----------------------?---------------?---------?----------------E---------------------------
----E----------?------o-------?------------------------------------------------------------------------------------------------------------------------------------o-------------------------?----------
---------------------------?---------------------------o-------?----?--o---------?----??-------E-E-------------------------------?------------?---------------------?----?------------------?-----------
--------?-------?------------?-----?----------?----?-------------------------------o--------------------E-------E-----?-----------------------------?-------?------------?----------------------o-------
---------------o----------------------------------E--------?---?------------------E-------------o--?---------E-???-E--E----------?--------------------?------------------------?-----o-----------------v
----------------EE-----o--------E-------------------------------------------EE----E--?------------?-------??-----------------Eo-o-----o---------------------------------------?-----o------------------f
-------------------------------?----------------------??--oo------?-----??---E------------?-----------------?--------?--?---------------------?-------------------E--------------------E---?-----------f
----------------------EE-------E---------o-----o--------------------?------------?--------------------------------------------o-----------------------------------------------?------------------------f
-?----E---o-------?--?---------?--------------------E---------o-----------o-------------------------?--?-o---E-----------------o---------------?----E------------------------------E-??----------------f
--------?-------------?-------?------------------------------?---------------o-----------------------------o-----------o--------?------?------------------------------------------?--------------------f
----------------|-----E-----|----------------------------o--------|----o-----|----E-----T--o---------------------------------------------------E-------------?-------------|--------E-----------------?f
m----o----------|||---------|-------o--|?|----------|---o|---|---?|--|---||--|-o---|--o|||------------|--|------|?------||--|----------o|--|-||----||-?---|-----|---|-|----|------|E---|----|-|-----||-X
XXXXXXXXXXXXXXXXXXXXXXXXXXXXXXXXXXXXXXXXXXXXXXXXXXXXXXXXXXXXXXXXXXXXXXXXXXXXXXXXXXXXXXXXXXXXXXXXXXXXXXXXXXXXXXXXXXXXXXXXXXXXXXXXXXXXXXXXXXXXXXXXXXXXXXXXXXXXXXXXXXXXXXXXXXXXXXXXXXXXXXXXXXXXXXXXXXXXXXXX
