--------------------------------------------------------------------------------------------------------------------------------------------------------------------------------------------------------
---?---------B--------------------o------E--?---?-----E-M-B----------E----------------o----E------------------------------B---------------------------E----M-M-------o-M-------------?------------------
-----?--------------M-------------------------------------B-------------------o--------------------M-oB--------o-----------------------B--M------o---------------------------B-------------E------------
-----------------------------------------------------E----------------?---------E-?---------------B---------o-E---------------------------------------------------o---------B-----------?---------------
--o---B--------------------------------------------------------------BE---------------------o-M---E--?--M-B--------------E--E-------------------EB----B-o-----o-------------------------?----B----------
---------------M--------?--------------------B---------?----------------B------------?------?-----?-----------------?------------------------------o--B----------B---------------?-------o--------------
----------------B------B--?-----M-------------------E------M----------E-------------?------------------------------------B------------?-?--B-----M-------------M--------------?-------------------------
----------------------o----------------------------E------------B---------------------B----------M-o-----B--?-------------o---??----------------------o----------------------------B-------------------v
----------------------?--------------o-----------B-----------------------------------------E--------------?-------B----M---M------E--------------B-----------------------------------------------------f
------?EE--o-B----EM-----EE-?-BE--?--X---BB----o-B-?-----o------XX--?---------EE-------------B----EBE-E---M-----B----------?-Eo----------?-----o----B-B----EEBoB-o?B---o--E-E----------E---B-----------f
--M--M----oM-M-----E-------B---oM-B---XX-----B----?BMo---o--?o--XXX--?----------MMo--E---?--B------B--oM--E---M--B--M---M---MM--o-MM--o-Mo--------B----B-?-BE?X---?----?---M------B--B--M-oM-----------f
-M----M-MM-?--E----?o-?-BoMB------M--o-XM-----?-XoB--------o-T--MX----o--B-------X---M-MEX------M--MM------XXX-----------o-B---------oo-M-----o-EB--B-----E--EXEM--E?-B----?--------M-----o-M?---------f
-E--B----M------M---T---M----B-M-----XoX-?--EE?XM--------X-X-|-----X---o-o--M-BTMXX-?--XXX?------B-----?oM-BXX-o--BT-ET--?-B--M---------B-?BX-?-o--?--?--o?----XX---M-MT----o-----?----------?---------f
----M?-B--BM?T-E---M|T-TX|-XEoTEM-?T-XX-?---XX-XXT--M--XXE---|-T--Xo--X-M------|-?X--X-EXMToT-T-TTTM-MBTT--EXBoE---|?-|B-X---oT--T?--M-TT--XX--T---|--T--T-T---XT-o--T?T----------?oT|-T--X-oo---------f
m-M|-X-X---Xo|------||-|-|--X-|BX--|-X-----X---XX|-|-B--X---X|-|--X--X--B----X-|---XXX-XXM|---|-||-|--X||-X|-X----X|--|-X-----|--|--B-B||---|--|B|-|--|--|-|---X|--XX|-||-------B--X||-|--X-X----------X
XXXXXXXXXXXXXXXXXXXXXXXXXXXXXXXXXXXXXXXXXXXXXXXXXXXXXXXXXXXXXXXXXXXXXXXXXXXXXXXXXXXXXXXXXXXXXXXXXXXXXXXXXXXXXXXXXXXXXXXXXXXXXXXXXXXXXXXXXXXXXXXXXXXXXXXXXXXXXXXXXXXXXXXXXXXXXXXXXXXXXXXXXXXXXXXXXXXXXXXX
