--------------------------------------------------------------------------------------------------------------------------------------------------------------------------------------------------------
-------------------------?-------------?----------------------------------?---------?-----------M----?--------------------------------------------o-------B---B--o----------E---------------------------
---E----------B-------------------E-----------o----E-------------o---------B----------?M---------B-----------?---------o--------------------------------------B-M---M-----------------------------------
----?-----------------------------------------------------------------------------------------------------?-----M--------o-----?--M--o---------------------------------------------------o---------E----
-------------------------------?------------------------M----E---------------------?--------------------------------------------E----M------------------------o-------B---------------------------------
---------o--------------o---------------?----------------B---------M-E----------------------o-------------------------------------------------B---------BB----------------------------------------------
--------------------------------------------E---------------?-------------------?M---------B----B--------------------------------------B-----------?--------------------------------------B-------------
--------------------------------------o---------------------------------------------------------------------M----------------------------------?----------------------------M--------E---?---------M---v
---------------------E----------------------------------------------------------------------------------------------------------------------------------------------o--B----M-----------E---o-----------
-M-----?-EB----M----o?---M?-E?M---M----BE-M--?--BE--------M-------?----E-E----?M-BoM----oo----------oB-M----oM--E--B??-----?---E--?-B--M--MB-------M--E---------E?------B------B--------B------?B----E--
----------------oM-------------B--E-----------?--M-----------E--ME--o-BB--?------o-o-------B?Bo---M------------B-----------MB-?--??---------E--M----o?---o------o-B--??--------B----M-E------M----------
--?----E-E-EX---o---o---M-BM--B----------------?--B?---M---oB-----oE--?E---B-B?X---E----EE-X-------B---------BB-?----------B-------MM-----E-?BM---E------M-E---???----oE-EoE-----M-------?o---Mo--oBo---
-E---?--B-?-X--M----o---o--E------o---?o-B-?-?------E---X-M---?B----o-X-o---M---X-o-----M--?X-B--M--------E--B-X------E-------B----M---B-EB-o--------M-----E---o-E---------o-M---E--o-oX-o--?-------oE--
-----o----XB----B---E--?----B------------o-X?---------EE-X--oB---oM?---X--XE--XX?EB---M----M-XoXX?-M?B------?--X--EoM-----?--?-E-B-B-E--------------E-M-------------??-M-----X--X-----o----B----o-X-----
m-?MX|X--M|X-X-M---oo-M-X----B--X--XXB-o--X--E--B---X-B-EXXX----X--X----X--XX--XX|?XX--oE---o-X-X-----B------X-?---?B--oMEo---XXE---BMX---X-B-E----X------?o--E--M----M--X?EX-XX-?-E--B---oXXXXEE-MX-o--
XXXXXXXXXXXXXXXXXXXXXXXXXXXXXXXXXXXXXXXXXXXXXXXXXXXXXXXXXXXXXXXXXXXXXXXXXXXXXXXXXXXXXXXXXXXXXXXXXXXXXXXXXXXXXXXXXXXXXXXXXXXXXXXXXXXXXXXXXXXXXXXXXXXXXXXXXXXXXXXXXXXXXXXXXXXXXXXXXXXXXXXXXXXXXXXXXXXXXXXX
