--------------------------------------------------------------------------------------------------------------------------------------------------------------------------------------------------------
----------------------------------------------------E-----------------------M-B------------------------?o----------M------B--------------------------------------?--------------------------------------
----------------------------Mo----------------------------------------------------B-E---------B----o-----------------------?----------?E---------o------------------------------------------------------
-------------M-------------------------o------------?---?----------o--------------------------E--------------------------------E-----------E--B-------------------------o-------------------------------
-----------------------------------------------o?-------------------M-----------------------E-------------------------------M-----M--------------M-----------E-----------------------------B------------
----------B--------M------------------------------------------?-----------------------------------------------------------------?----------E--------------------------------------------------E---------
----------------------------------------------?-------E----M----B---------------------------------------B------------------------------------------E-------------------------B----------B---------------
-------------E--------------------------------------B-M------?-------o----------------------------------------------------------------------o------B-------------M------------------B------------------v
----------E---------------------o-----------E-----B----------?-------------------------------o----------------------------------------------------------------------------------------------------------
-----?-?------M--M-E-B-M----Eo-------B-------B---o-M-?o------M-----------------?--------M?-MoME--------B-o--oM--B-?--E-M----?--------o---o--oo--M-----B--B--?-?-E------o--------E----o-E?---B-----------
--M----E---o-------?--B-?-?E-X?EE?----------EEM-----E-------E---------?------------B---BB-----?--o---B------o-------X-----?----M----o-o-?o--o---------o-E----------B----?--?-----M--E---E-Mo------------
-----M--?EM-oB-----------E-E-MX------?---?E-E------?E--o---------?-?-----o--E---o-M----o--EM----Mo--??---?----?----oX-oE-------M---?----------EB---M-o----E-B-M------??----X----?------o----EE---B--B---
----?----M?----M---E----M---?--------M-------------M-B?---o---M----Bo-B--E--oM-B-----X-BB-----X---o--B--B--o--X-M--EX-XXB--B--?-M--B---o---E--E---?---X-B-B-E----Xo??---X-X--E-?o-----X--EM--B-oE-------
-o---o-EX----oo-XXX-X?B-B-?--XX--XB-----BX--X---E----B-MX--E---M---X---BX-XoXE------?-X-E--oM-X-?------Bo-B-X-XE--MX---X-----o------oE-B---oM--XX-----MX--M----XXEX--o---X-XBM--Xo---oE?---M-BBB?--o----
m-MX|XX-X--X-E---X--X-X-E-?-BX-XXX--XoXXX-XX-XX-B------EX---B--X--X---X-M|?-XBMB?|oM-XXXo--?---XEE------XBE-XXXEEBEX--Xo---X--X---?----X----B-oMX-X-X---oX---XX-X--X-X-BE?XM--MMXXB--XMM-X--XB-oX-XoE---
XXXXXXXXXXXXXXXXXXXXXXXXXXXXXXXXXXXXXXXXXXXXXXXXXXXXXXXXXXXXXXXXXXXXXXXXXXXXXXXXXXXXXXXXXXXXXXXXXXXXXXXXXXXXXXXXXXXXXXXXXXXXXXXXXXXXXXXXXXXXXXXXXXXXXXXXXXXXXXXXXXXXXXXXXXXXXXXXXXXXXXXXXXXXXXXXXXXXXXXX
