--------------------------------------------------------------------------------------------------------------------------------------------------------------------------------------------------------
--------------------------------------------------------------------------------------------------------------------------------------------------------------------------------------------------------
--------------------------------------------------------------------------------------------------------------------------------------------------------------------------------------------------------
--------------------------------------------------------------------------------------------------------------------------------------------------------------------------------------------------------
--------------------------------------------------------------------------------------------------------------------------------------------------------------------------------------------------------
--------------------------------------------------------------------------------------------------------------------------------------------------------------------------------------------------------
--------------------------------------------------------------------------------------------------------------------------------------------------------------------------------------------------------
-------------------------------------------------------------------------------------------------------------------------------------------------------------------------------------------------------v
--------------------------------------------------------------------------------------------------------------------------------------------------------------------------------------------------------
--??--M--?-------o--E-----?--M-----------?-------B?---E--o--E----?-------B-?-E--Mo--oM-B------------------BB-oM?oM-----B----oM---?--EEE--E-??-?---B---?E---------B--Boo----------E----E----oo-?---------
-----oEM-------?---E-B---T---M-----?---B--?--o-----B----B----?--------?--------------B--MBB---------M-o?---o----E-M-E-----------o-----E------------------B---o--B---B-Bo-o------E----------oo----E------
----XoM------M-B-----?---|--o----o---M----------To-?-o-----E-MTo--T--------?---T-?--?----E-?B-----?------?-Too---?M--EMB-T--------B------B-EB-T---------B-----o--?----EE----M--T-------------T?o?--B----
--E--XX?------Moo-o-T-o?B|E--T--B---o-----o?----|-M--?T-------|--o|---T----o--M|---------oT--T-----E---T---|ET-MooT---M--|T--?-----M-o-----T-?|---------?-M-T-o?----T---o-----E|---T--o----M-|-?-----B--
--TT--XTT----TT--T--|T-XX|T--|--M-T-TTT-----oM--|-Too-|-TT-?T-|---|T?-|---TTT-o|TT----o?TM|T-|-T-TTMT-B|T-M|-|ME-X|--T-TT||-?-T---TTB---MBE|-T|TE---o---TT-B|-XT-TTT|-oTX?o---T|TT-|--T-?E-?T|-TTT-TT---
m-||--X||----||--|--||--X||--|----|-|||---------|-|---|-||--|-|-XX||--|---|||--|||------|-||-|-|-||-|--||-X|-|--X-|--|-||||---|---||-------|-|||--------||--|-X|-||||--|-XX--X||||-|-X|--X--||-|||-||---
XXXXXXXXXXXXXXXXXXXXXXXXXXXXXXXXXXXXXXXXXXXXXXXXXXXXXXXXXXXXXXXXXXXXXXXXXXXXXXXXXXXXXXXXXXXXXXXXXXXXXXXXXXXXXXXXXXXXXXXXXXXXXXXXXXXXXXXXXXXXXXXXXXXXXXXXXXXXXXXXXXXXXXXXXXXXXXXXXXXXXXXXXXXXXXXXXXXXXXXX
