--------------------------------------------------------------------------------------------------------------------------------------------------------------------------------------------------------
---------------------E---------------------------------------E----------o---------------------------------------E-----------o--?--M-----------M----------M-------------M--------------------------------
-----E--------------M----B-------------------------M-----E-----------?---------------E------------o------oB---------?----o---------------o------------B-----------------------M----------B-?------------
-----o---------M---B-------M---?--B----o--------M------------------------------?-----------------------?--------------o------B---------------o-----o---------------------------?------------------------
---------------------?--------------------M--------------------------------------?oM---------o-------B----------------?------------------------------------E-------------------------M------------------
------------?EB---E-----------------------------------------------B--M---------B-------?----------------B----B----------------M----------?-------?-------?----------------?---------B-------------------
-----------------------------?-------------------------B---------------------o-------M-----o?-E-----------EE----E?---------?---EE-MB----------------------E--------?------------------------------------
--?---------------?o?---------------E-----------?-M-----E--------M--------------M--?o--o----B------------?----------------------------?----------------------------------------------------------------v
--------E----------------o-----------------------------------------------------B----------BBM---X---------------o-------------------------------o-B----BMM-?------------------?--B---------------------f
-?---------?----E-M--------?----M-E------Bo--?--E------oE----o---------------M----?B--M---B----X-?-------?---BM-XB--------B-M-o-oo--------?-----oMM---?----B-EE-------oo-?----ME-----------------------f
-o----?o--------------M-----BM---B-------------M?-M--?--?------B---??--EMB-----------M----E---EX--B----B-----?ooXB---o--o-?-----B--?o--E-E--?X---B---B-----E--E----?o--o----E------EB--B----?----------f
--------?T-oEB----------------?-E-M--M-oo??-B----X----------M-------X-M--BM?--o---M---------??MX----o-o------X-XXo-----?o-B--o---M?------E--MX-o-----?--B-MM-E----E-B-----------B-o-B--o-E-------------f
-?----?oo|?--X--M----o?o----o----T--o-EMM--B-------------T----------X-?T------o---EM----------X---o---Eo--X--BXo-XX------------Eo--X------o--X-MM--T---M----M---XX--M-B--E--o?----BB-?---XX--o---------f
----T-T-MToX-X--MM----B---o------|--E-oM--------XXT---oX-|--MoX-T--oXE-|-M-?MMT-?oE?-T--------T-?X-?T-ET-X--BXX--XEBoTMo--------?-oXTT--XX?T--XE-T-|-TTBT---T|---XBT-X-T-TT-MT-oT--T-X-?XM--XX---------f
m--|--|--|-XBXX-B|-|-------B|-X--|-----X--|-|--X-X|----X-|--XXXX|--X|---------|-|----|---|----|-EX|-||---X---XX--X-oX|---B-----XBXX-||-X-XX|--M--|-|--|?|---||-X--X|?|-|B||-X|--|--|--X|--X|-X---------X
XXXXXXXXXXXXXXXXXXXXXXXXXXXXXXXXXXXXXXXXXXXXXXXXXXXXXXXXXXXXXXXXXXXXXXXXXXXXXXXXXXXXXXXXXXXXXXXXXXXXXXXXXXXXXXXXXXXXXXXXXXXXXXXXXXXXXXXXXXXXXXXXXXXXXXXXXXXXXXXXXXXXXXXXXXXXXXXXXXXXXXXXXXXXXXXXXXXXXXXX
