----E-------E--------------E-----?---------------------------------------------?-----------------------------------o-----------o----o-o-?-?-------------------?--------------?o-------------------------
----------?--------------------------o---------------------o?------------------------E----------------------------?----?-----------------------------------------------------------?-------------o------
--------------------?-----------------------?---------------------------E---------------------E------------------?--------?------------E----------------------------------------------------------------
------?----------------------------------------------?---------?o-----------------E---------------------------o-----------------------------------------------------------------------------------------
------------------?---------??--------?---------------------------------------------------?-------------------o------oo--?---------------------------------E-----------------------?-----E--------------
----o-----------?----------E--?-?----------E----------------?------------?-----------------------?------------------------o-?-----------------o------------------?---------------?------o----?--E--???--
--------?----------------------------o--------o------------------------?------------------------o--o---------?------------?----o------?--------o----------E?-------------------o---o------------------?-
------------------------------------?--?----Eo-------------------------?---------------------------------------------------------?-----------------o---o---------------------?--------o-----?----------v
---?-----------Eo--?--o-o-----------E-------------?-o-o--E??---??--E-E--?----?E--------------E---?-------?-E---oE---?-oo--o-----o---?-----------o-------?-------------------o----?----?-?-----?--E---?o-
-E---E---------?-----------o--------------------E--------o-------?o--?---?----E-o--?------------------o------o---?---o----o----o---o----E-----?-??---E?--------------EoE------------o-?-----------------
---E--?----E-------Eo?----??-----?o-----?------?--o--?---E-oE------E--oo--?--------------------o----o-E--?---??o--------?----o?-?--------------Eo-------?---?--------?----?---?-?-----------o--E--------
----?--E-?----------?--------?--E--o?-----?-?---E-------?---?E-?---E------o----EE--------------o-----E----------?----?--------?---?E--------------?-------------------------??----o--------------E?-----
--?oE----o--?------E?---------E--?----o-----E?---?o---?---?------??-----------?----?-----?------o------?-----------?E-o--E-----------?--?----------?oo--?----------------------?----??---o------o---?---
-????-----TET--?-?---?E-----|-ET-E----|---?o?T?---------?---|------oo--o---------?T-?----|E-?E-?T---E-----|-----E---E-----------|o----------|---?--T--|---?oE--o-|--------E|----|-E-o-?----o|E-T--?-|---
m----o?||?||||-|||-||||?-||-||?|||||||||--||-Eo---oEoo|-|?--||-E?E||||-|o--||||||?|-|---?|-|--|||?|--E---||?------|o|-|-||oE|||||||o-||||-|-||o|||?|?||o|E-|?|||-|-|||?|??|||--||?-||||||||-||-|||--|||-
XXXXXXXXXXXXXXXXXXXXXXXXXXXXXXXXXXXXXXXXXXXXXXXXXXXXXXXXXXXXXXXXXXXXXXXXXXXXXXXXXXXXXXXXXXXXXXXXXXXXXXXXXXXXXXXXXXXXXXXXXXXXXXXXXXXXXXXXXXXXXXXXXXXXXXXXXXXXXXXXXXXXXXXXXXXXXXXXXXXXXXXXXXXXXXXXXXXXXXXX
