-----?---------------------?-----E---E----------------------------------------E-------o----------o--------------?o----------------o-o-------o-?----E--------------E-E---?--------------E-E--------------
-------E--?-----E-----------------?---?-------?---------?---------------E?-E----------?----------------?------o-----EE-------------------o-----?-o-------------------?-------------------------?---?--o-
---------------------o----E---------------------?--?-----?----------E----------?-------------------------------E------?--?----o----------------o-----E-oo----------------?----------?-E--------E--------
----o-------------------------------------------------oE-------------------------?------E---------?-------------------?------E------E---?------?----------------?---------o-----------------------------
-----E--------------------------------------o---------------?------E---o-?------------------o------------------------------?---?--------------------o-----o---------------------------------o-----------
-----o---?--?-------o---------------------?-----?--E-----?--------o-------------?------E--o--?-------------o---?----------------?--EE--o------?----E--------------------------?---------?--E------------
----?-?--------------?------E?o-------------E-----?--------------E------------------------?-------------------?--?--E?--?-------------E--------?E-------------------E-------?--------?-------??---------
----E--------?-----?---------------------------?------------?------?------------o------?---------------------------o----------o-------?-----------------?--?-------------------------------?---------?-v
----------o-------?---o-------------------------------------E----------E--------------------o--E-----?--?--------?------?------?------------------------------------------------------E---------o------f
---------------o-----------o-------------?--------?--------E--------------?--------------E--?-----?-----------------------?-------------------------------------------------------?E-------------------f
---o-?--------------------------------------------------E--------------------?------------E?------------------------?--------------?-----------E---?------o--------------?---------------------------E-f
-------------------E-------------------------------------------------?--E---o---E---------o?------------------?---------?-------?---------------------?---o---?---E---------?-----------------?--------f
----------?-------------?-------------?-----------E---------------------E--------?-------E-E---------------------------------?--------?---------o----o-------o----------E-E----?-----o---E-------------f
------------E-------?------------E------------------------------------?--?---|-?o-------------------------?-------------------|----------------------?--------o|------------------------|-------TTo---Ef
m-?---|||?-|E|?-----||-|-|?-o--------|--|------oE---??--||-----?--EE----|--|-||?---------|--|-----|-----?---||E|----?------|--|--|----------|-|-----------|-o--|----------o-||----?-----||------||-----X
XXXXXXXXXXXXXXXXXXXXXXXXXXXXXXXXXXXXXXXXXXXXXXXXXXXXXXXXXXXXXXXXXXXXXXXXXXXXXXXXXXXXXXXXXXXXXXXXXXXXXXXXXXXXXXXXXXXXXXXXXXXXXXXXXXXXXXXXXXXXXXXXXXXXXXXXXXXXXXXXXXXXXXXXXXXXXXXXXXXXXXXXXXXXXXXXXXXXXXXX
