--------------------------------------------------------------------------------------------------------------------------------------------------------------------------------------------------------
--------------------------------------------------------------------------------------------------------------------------------------------------------------------------------------------------------
--------------------------------------------------------------------------------------------------------------------------------------------------------------------------------------------------------
--------------------------------------------------------------------------------------------------------------------------------------------------------------------------------------------------------
--------------------------------------------------------------------------------------------------------------------------------------------------------------------------------------------------------
--------------------------------------------------------------------------------------------------------------------------------------------------------------------------------------------------------
--------------------------------------------------------------------------------------------------------------------------------------------------------------------------------------------------------
-------------------------------------------------------------------------------------------------------------------------------------------------------------------------------------------------------v
--------------------------------------------------------------------------------------------------------------------------------------------------------------------------------------------------------
-----EX-X-?--o----------o---?-XoX-XX---------X-X-?-----------X-?E-----o---X---X-XEX----------E----E-----?oX?-----?o-E--XX----?---?------E?X-o---X-o-E----XX-?EX-o--------X-------o-EX---XXXoo-o-----E---
--XE-?X-X------------?o---?----X?XX--E--?-----X-EX--?----???-X-?X----Xo---X?-X-X-Xo---?---------o-?------?X--X--E-?-?--X?--------?--------?X??---XE---E?XX-Eo--X--?---?oX-X----E--XX-----XXXE?------?---
--X-EEoX-E-E-?----?----------?--XX-------?---oXXX----------XXoXX----XEo--X----XEX---------X------?---------X-oXX------?-X----?---?------X--X?---XoXo-E-?-XX--EXX--X-?o-?X--X-------XXXo-XX-?X-----?-----
--XXX-XX--??---?-------E----o--XX-----??----EX-X-o?-Eo?--o?EXoX---X-XX--oX??---XE--E---??-XX----------o----oX-X--------E-X---?-o--------XEX----X-X--o-?--X?--ooX?XX-o---?XX?o--?----XEX--X?X?-----X-----
--XXE--X-?--X-?--?E?E-EX------X?-XX---X--o----X?-Xo---E--oXX---X?--XX---EX-XE-?oXE-XX--E---XX-o--------E--XE-X-E----XX-??XX---X-----X--??XX----?XXX-----XX-X-o-XXXoX----X-X--?----XX-X?---X-Xo--E-?Xo---
m?XXE-X?--XXEE--X?-XXoX-X--XX-X--XXX-X?-XXE---?XXXEX-o-?XXXEX---XX?X-?-XX-EX?XXX-XEX???-?XXX--?-?--XXo--E?-X?XX---X--XXX?XXX?XX-?-X-XX--EXXoE?--X-X--o---XX-oX-XXXX-o??-?XX-XXE---X-X-o--?-XXX--?-oEXX--
XXXXXXXXXXXXXXXXXXXXXXXXXXXXXXXXXXXXXXXXXXXXXXXXXXXXXXXXXXXXXXXXXXXXXXXXXXXXXXXXXXXXXXXXXXXXXXXXXXXXXXXXXXXXXXXXXXXXXXXXXXXXXXXXXXXXXXXXXXXXXXXXXXXXXXXXXXXXXXXXXXXXXXXXXXXXXXXXXXXXXXXXXXXXXXXXXXXXXXXX
