--------------------------------------------------------------------------------------------------------------------------------------------------------------------------------------------------------
--------------------------------------------------------------------------------------------------------------------------------------------------------------------------------------------------------
--------------------------------------------------------------------------------------------------------------------------------------------------------------------------------------------------------
--------------------------------------------------------------------------------------------------------------------------------------------------------------------------------------------------------
--------------------------------------------------------------------------------------------------------------------------------------------------------------------------------------------------------
--------------------------------------------------------------------------------------------------------------------------------------------------------------------------------------------------------
--------------------------------------------------------------------------------------------------------------------------------------------------------------------------------------------------------
-------------------------------------------------------------------------------------------------------------------------------------------------------------------------------------------------------v
--------------------------------------------------------------------------------------------------------------------------------------------------------------------------------------------------------
-?----------EX---M-------o-B------B-------E?---o-o---o---------?-----BEE?--?-MB?----?---?--o---?--E---M-B-BM--------M-B-----X---------BB--X-----------BM---BB--M---XX----M-oB-----M-M-?---o-o------B----
---------??XXX-------?---o-----------o----?oE--B---B---E--M--------------EM--E---B---E-o-?-ME-E-M---E-o---oo-E------?o----BoXX-----?-----BX-?B-ME---M-?-B---------MXX--o---B--EE--E---M?o?----EMo-M-----
------M-----X--------------ME-M-----?--------------E------B-----ME-E----o--?oE---?---?--o?---BM?M---o-B------?---B--?-----E-X---?---M-E--?X-oB--?--E-------?-E----XXM-B----------Eo?M---EM-M--M-----E---
-?--B---M-MMXMX------oB------?-?--E----BE----Bo---B----o----B-?-----E?-B---B?---BE--?-----B-?oX-X--BXX---B------o-X---------X---------MXX-X----BM---?B?--B-M---E--XM-B-?----BMo-?---?---------X--oE-o---
---X-?----XX--EX-------BX-XM-B?----o-----Eo?---------o?E-------BMBB---?-----------M--XBE-B-o-X-XEE-?X-o-----E--B-BX---M--M---X-----E-?-X-?XXB-----B---Bo----E------XBX------o--BXX--------B---?X--------
m-X-B--?XXXXM-X-X-X-E--BBX-X-?B--XXX---XMXEo---B-XM-X--XX--?------B?--X------MXXo--E-X--XXE--EX--?-X---o?o-o?-----MXo-X-?--o--X---?-XM-XM--XX------Xo?-E-B-----XX---X-o-MEXX--B-X--o-?-E---XX-XoE--o?---
XXXXXXXXXXXXXXXXXXXXXXXXXXXXXXXXXXXXXXXXXXXXXXXXXXXXXXXXXXXXXXXXXXXXXXXXXXXXXXXXXXXXXXXXXXXXXXXXXXXXXXXXXXXXXXXXXXXXXXXXXXXXXXXXXXXXXXXXXXXXXXXXXXXXXXXXXXXXXXXXXXXXXXXXXXXXXXXXXXXXXXXXXXXXXXXXXXXXXXXX
