----------------------------------------?----?--------------o---------------------------------------------------------------o---------------------------------------------------------------------------
--------------------------------------------------------o-----------------------?----------------------?------------------------?------------------------------------------------------------?------E---
-----------------------------------------------?------------------------?----------E---------------------------------------------------------o---------------------------------------o------------------
----------------o-----------------------------------------------------------o--------------------------E---E---------------------?---?-E----?-o-------------------------?-------------------?------E-E--
--------------------------------------------------E----?-----------------------------------------------o----------------------------------------------------E-------------------------------------------
-------------------------------------------?-----o---?--------------?-------------------------------------------?----------E-----------------------------?-E--------?------------------------------o----
----------?----------E-----o------------?------------------------------E------------?------------------?-------------------------------------------?-----?-----?--E----------?--------------------------
-?-------------?-?----------?-----------------?---------------------------------------------------------------------------E---------o------?---------?----------------------------------------E--------v
--------------------------------------------------------------?--------------?-----o------?-----------------o----------o--o----?--------------------------------?-----?--------------------------o-----f
------------------------E-?-------?-------------------------E-----------o--------------------------?--------------------------------------------------?---------------------------------o--------------f
------------------------?E------------------E-----------------------------------------------------------------------------?---o---------------------------?-----------------------------------o--------f
------------?--E--------------------------------------?-----------------------------------?------------------------------E----------------E--------------------?---------------------------------------f
------------E---------------------------?-------------------------------------------------------?-?-?----------?--------------------------------------------?-?--------------------------?-------------f
------------------------------------X-------o--------------------------------------------?--------o----------------E----E------------------------E-------------?-------------------------?---o---------f
m-----?------E----X-----------------X------|-------------------------E---------------------------|------|---------------X---------?---------o--------------X-------------------------------------X-----X
XXXXXXXXXXXXXXXXXXXXXXXXXXXXXXXXXXXXXXXXXXXXXXXXXXXXXXXXXXXXXXXXXXXXXXXXXXXXXXXXXXXXXXXXXXXXXXXXXXXXXXXXXXXXXXXXXXXXXXXXXXXXXXXXXXXXXXXXXXXXXXXXXXXXXXXXXXXXXXXXXXXXXXXXXXXXXXXXXXXXXXXXXXXXXXXXXXXXXXXX
