--------------------------------------------------------------------------------------------------------------------------------------------------------------------------------------------------------
--------B--------------------------------------------------------E-----------------o------------?o---------B---------------B-------------?---------------------B-Mo---------------------M---------------
---o------------B?-------E---------------------?---M-------------o--------------------------M----------------------------------B-?-------------------E---------------M----------------------------------
------o---oM-----------M-------------------------------------------------------------B----------------B------M---------------------B-E----------M?--------o--o-------------?---?--M---------------------
-------------o------?-----------E-E----------------?--B-----------------------------o--?--------------------------------------------------------------E----B------------------B-------------------------
----------------------------------------------------------?--------B------------?----------M-M--------oM--?----B-----B--------?------B-M----------B------o-M--------------------M-----------------------
------------------E---B--M--?---------o------------B-----------------B--------------------M----M--------E--o--B------------------------------B-----------------o------------?---------------------------
-E----------------B--------o---B-------------------E--M---------------------------------------?----------------------?---------------------M-------------------------M-?----------?---o-B----?---------v
-------?----------E-----E---------------------------------------------E------------------------------------------------------------M-----?--------------------------------------------------------------
------o---B?---B--------o-o-----------B---------BMo---?---------o---ME--o---------B------o----?M-BB-?---X-E-----M?-------o--------E-XX-MB-E---?----?-EM---?-M---o-o-o----o---M-------E--M---------------
-E---------E-----o----?-B----EM-------?-B-------------?oEB--E-o?---E----E-E-M---oo---M-------?BB---E--E-X---------E--?---E----B---MXX------B-M-o-B----------E?--E---B-EoM?----------X-B-----------------
-MB-EB-o--?oo------?E---ET-oo-o-?-o?--?B----M-B-?--E-------M---?o--E--o?B-T--?-E-B-E-----o--------B----oM-B-o-----------E---Xo-----EX---o-M---?BM-B--?-?--M------------?----?oE----X----B-?-------------
-M------o-E-o?-----B-E-T-|--E--?-----M-M-o-E?o---o-T-----B----BE-X-X-B-EXX|BBBE---?-M---E----o--M?--T-EX-M--T--M-?-EX-?----B-X-oB-M--X-TT-E-------?-|E----?-X?-|--?M-E-------------X-E--EX--T-----------
---T-----B?TT---|---XM-|o|--T----?-T--|--X---------|-|----o--?-oB--XET??--|--X--BM?-T-|-BT-T-T|-T-?-|-XTo-T-TB-----XXE?----TXo-------XBT|?-|-T-MEM--|-EE-X--TX-To-X----?-T-EB|----XXBMT---X-|-----------
m--|B--|-XX||oXB|--oXXB|-||-||-----|B-|||-XX|--|-B-|||-B--X||--XXXX--|--EX|--BXXXE--|-|--|-|-||-|X|-|-X|--|-|-XXXB|-X---MX-|-X-B-----X-||--|-|B--X-X||---X--|-X||-X--XXX-||-X||-|--X-X|--X-X|-----------
XXXXXXXXXXXXXXXXXXXXXXXXXXXXXXXXXXXXXXXXXXXXXXXXXXXXXXXXXXXXXXXXXXXXXXXXXXXXXXXXXXXXXXXXXXXXXXXXXXXXXXXXXXXXXXXXXXXXXXXXXXXXXXXXXXXXXXXXXXXXXXXXXXXXXXXXXXXXXXXXXXXXXXXXXXXXXXXXXXXXXXXXXXXXXXXXXXXXXXXX
