--------------------------------------------------------------------------------------------------------------------------------------------------------------------------------------------------------
---------------------------E-----------------------------------------------?--------------E-------------------------------------------------M-----------------?-----------------------------------------
--------------------M---B------------------------------o-B-------?---------M-----------------------M-------?-M------B-----o-----------o------------------?-------?-------?-M---B---------?--------------
---?-------------------------------------------------B-----E--------------------------B-----------?-----------------------------------------------------------------o---------------B-------------------
---------------------o------------?E---------?-------------------------B--------------------------------------E----------------------EE-----M-M----------E----------------------------------------------
---------B------------------------------B-----------?--o------------------------------------B------M-------------------------------------------?-------o---?---------?--E-------------B-----------------
-----B------------E---------------------------------------Eo----------?------?-----------------o-E--------------?-----?----------------------------------B-------M-o-M-?--------------------------------
--M--------------------?------------?------B---------B--------o------------------?---B-----------------------------E--------------E----------------------?---------?E------?---------------------------v
-------------------------------?--------M-E---------------------------------------o---------M----------------------------E--E---------M-------M-------------------------------M-------------------------
----B-o?-------MB----BM---------oB-ME---oBB-BMoM------?-BM-----B--MB-B---?---M----o---oBM-?--XX-X-MB-M---B--?-o-------M-------?MMX--------?---B-B-E---------o-o----?-----------------?---B--------------
---o-Mo-o--?---??B-M--?-M-M-B----------?--------o--E----?B-----------XXM--E----E---B----M-o-------?----B-M------E--M-?---E------X-M-?--B--E-----------M-----Eo-o-B--o---MM---M-----o-------B-M----------
---------EE--E----|----E---M--BB?---B--?---o---M---------E--E-B-o----XXX-oMB-----E-E---o?B---EX-B--ooE--E------?---B---B---?o-----M------o---------?X-Xo---?---------------------------E----------------
-----?B---E?------|--?----EB-?M--o--??-MMB---------oE---M----?---|--o-XBoX--M---|-E-----XoX------------oE-B-------o?---EX--M-?B--XX--E-o?-EB--M--?-BXXX--XM---To-M--o-B---------o--E-T--E-?-TT----------
-T----T--M--MTEE--|--?X-ETXE-TT-E------T-o-?MoX-T----?XX---oo?-M-|-TEX--X--|-To-|-T--T-B-XE--XMX--TB-T-EX-T-ToT-T|-T?--Xo----TM-TTX-B--|---BT--TX-X-BXM---X---|-|---TX-o---TT?-----TT|--X-TM||----------
m|----|------||--X|----XM|B|-||-------B|--M||-XX|-|--EX-XX||--X|-|B||-XX---|-|--|-|--||-oB|-X-X--B|--|-X--|-|-|-||-|-X--X--|-|---|-|---|-|--|--|-X-MXX-Xo|--X-|-|-|-|-||-B-||--|-|-|||-XX-|-X|----------
XXXXXXXXXXXXXXXXXXXXXXXXXXXXXXXXXXXXXXXXXXXXXXXXXXXXXXXXXXXXXXXXXXXXXXXXXXXXXXXXXXXXXXXXXXXXXXXXXXXXXXXXXXXXXXXXXXXXXXXXXXXXXXXXXXXXXXXXXXXXXXXXXXXXXXXXXXXXXXXXXXXXXXXXXXXXXXXXXXXXXXXXXXXXXXXXXXXXXXXX
