--------------------------------------------------------------------------------------------------------------------------------------------------------------------------------------------------------
--------B-o----?MMo--------------------------E--------------?----------M--M---?---EB?M----------E--------------B-------------M----E-B---o-M------------------------M--------------------B---------------
----------B---o-o-M--Mo-------M-?--?----------o------oEBE--------------?-------------M--E----M---B-MM--------M--B-----M---Eo------?-EM----------M--o--------------------------M-M---o---?----M----------
-M----o---B--E--??--E---EM--------o--o--M-?--------o-------M---oEE---M------B--------B-o-------o------o--M---M-M------Bo------M?----------BE-------------B?-------E----?-E-M----EBE--E-------o----------
-----M-E----------?B-B------------?-------B-----------------E--E------------E-E-M----M----------------?--M------------M--??---o---------B-o-?------?Bo---E---B-----o------o--B-oEB--M--Bo---------------
-----B-------?--M--M--B-----E-----------M------M---E-----?------?B----------M-B---------M------B-BM----------B--o----oM--o---?------------ME-?------B----E-B-o-?-E-B----MB?----------B?-----------------
--E-------?-M------E------------M----------MB------B--BEo--------E-------?--M-----M---E--------o--------?----o---------B----o-------------?-?---M--Mo?-------E-------?--o--------E------oo--X-----------
------------E---E-o-----------o---------B---------------------------MM--?--M-----o-----E---B-B--MM--B---M---o------B---E--?-------------------------B-M------------B------------------E----MXX---------v
-?-----?o-B--------------------------------E-?-ME------------oX-------------------?---------------?-M---------Bo----o----M------Mo---------?M--o-----B--------?------------------EEBoo-o----X?---------f
---B------------?--E-----M---M------------B-?M--EE--?E--B------X--o-----?---?-------B----Bo-o----?--M-M------Mo------M--------?o-X----------o-X--BE------?-----o-?o---oMo------B--?---------BX---------f
---B--B---o-EM-B---------------Moo---------------o---M-----B--MX---TM-E-oo-o------EE-E-----B-EM---M--------------E---Mo----oE-X-X----??E--?-?--XX-BBM--EB--ooo--o-o?-oXE-o----MM-E----------X----------f
--E----?--MM-------B-E-E-------------------METM------XBX--B-B-XX---|---E-?-----?-?-o-------B----------?B--?-o-BM-----T--E-o-X-X----------?-M-M-X--oo------TB--M---?-|-XB--X---?---o--o---?--XX---------f
-----M----XB---M-T--o-BEB--TE---|----BETB----|-MX-----XE--M--T?X-|-|----M--E---E-----X-X|XT-o----------?-ET-o--B-?------o?--X-----------oM---|----|-------|--Eo-?oXT|-M-EoTXXB-------------|-|---------f
----o-----X-----TT|-?XTM---||--T|-|--X-|-|--E|E-||-ooMT----BM|---|-|-METTM|--M-?X-|-MX--|BTM---T??----|-M-|-|--|-XX?-T-T|--o-----T|-T-TB-M-|-|--|-|B?|-E-X|-|--XX-XT|-XT?-||-X|--MT|M--|--T|-|---------f
m--||-|-|-|M|---|||-XX|--X-E|-|-|M|--?X|B|-|-|--||--?-|-|-B|-|--X|-|-o-||-X|--B|-X|-?BX-|-|-X|-|----XX|---|-|--|-XX--|-?||-B-|-|-||-|-|oo|-|-|--|-|-B|-oM||?|--|--XX||-||-||-||---B|-|E|-X||-|---------X
XXXXXXXXXXXXXXXXXXXXXXXXXXXXXXXXXXXXXXXXXXXXXXXXXXXXXXXXXXXXXXXXXXXXXXXXXXXXXXXXXXXXXXXXXXXXXXXXXXXXXXXXXXXXXXXXXXXXXXXXXXXXXXXXXXXXXXXXXXXXXXXXXXXXXXXXXXXXXXXXXXXXXXXXXXXXXXXXXXXXXXXXXXXXXXXXXXXXXXXX
