--------------------------------------------------------------------------------------------------------------------------------------------------------------------------------------------------------
-------------------?---------------------------------------------------------B--------------------------B--------o------------------------------?---------------------------------------------o---------
---------------------------------------------------??--------------------------------------------------------------------?----------------------------------------------------------M----------M--------
---------------------------E---------------------?-?-----------------------------------------------------------------------?--------------------------------o----E-----M---E---?------------------------
---------------------------------------------------------------------------o--------------------------M-----M?-------------------E----------------------------------------M------------------------M----
--------E-------B------------------------------------------E--------------B---------------------------o-----------E------------------?----------------------------E-------------------------------------
----------------------?----------------------B--------------B------------------------?------------------------------?---B----------------------------E-------------------------------B---------?--------
-----------------------------------------------------------------------------------M--------?------B-----------------E---------------------------------------------------------------------------------v
----------o---------------------------X--------X-------M--------------------------------------------------------------B---------------o---------?----------------------BX------?---B-------------?------
----o--o-X-?-E---------M-M--o---?-??---XooXXXXXXXE-E--o?X-o---E--?-------X-X-Xo?--E--------------------o-E--X-B?----?----E-----oXo--oX--??M--?----E?XEo---?-E---o-------Xo-XX-?--?--E---------------E---
-?-?-?--XE-----------------?--o----Xo?--X-X-?XXXX-?o---MX?------?--X---?--XXo-X--X--M---?---?o-------XE---oX--X-o---------E-o--X--?-X?X?--E----E?-XX-?o-----------------XXXX-----o-?X-----o-----?--o--o-
-?-o-?--EXX-oo-E-----------X-E---XX-E-?XEXo--X-X-----?XXX?----------?-----EX?X-XXo-E----------?--E---oX?BXX--XX--B-?---E------X?--?--XXoE?oM----XXX---E-E----o-?oM-?-?--?XXX--Eo?--X-o-----E?------o----
--o----?X--?---X-----E----EXXEo-oX-X-??-XX----X-------XXoE-----?-?-X-X--?-E?-XX-X-X--------------------XXX---XX-------X-X---o--XXX---X-oX--o--XXX-X-X--X--E?--o-E----ETX-?XXXXX--X--X------E-----o---?--
---o-o?o?X?-?-X?--?---E-?E-X--ToMTX--?--EX---oX?--?-?-X-X-------X-X-X-X---XX-XXX?X?--------------?X?XT--Xo--EXoX---T--?XXX-?---TXX?X-XXX-?-----X?--X--?XXTX--XX-?-----|---XX?XX---XXXo---?-E-??o--------
m?---X|-XX--XXoXoX---X---XX|--|-?|X-XXEo--Xo-X?X--X--XX-XXo?E--X?--XXX???X?X??X-X?---?--E--E--E--?-X-|--X-X-|XX|?-o|--EX-XXEX-o|-XXX-XXXo--E--|?----XXX-X|Xo?X--XEo?E-|--XXXXX|E--oX-----E-?-o?--|-?|-X-
XXXXXXXXXXXXXXXXXXXXXXXXXXXXXXXXXXXXXXXXXXXXXXXXXXXXXXXXXXXXXXXXXXXXXXXXXXXXXXXXXXXXXXXXXXXXXXXXXXXXXXXXXXXXXXXXXXXXXXXXXXXXXXXXXXXXXXXXXXXXXXXXXXXXXXXXXXXXXXXXXXXXXXXXXXXXXXXXXXXXXXXXXXXXXXXXXXXXXXXX
