--------------------------------------------------------------------------------------------------------------------------------------------------------------------------------------------------------
---E------------------M?-M-----E-?----E----MM-------?-----------------E--MoE----o-----?------o---------M---------M-B-----o-----?M---------------------MM-----?------M---o------B------?-----------------
--E-M---?----M-----M--M--E----------------E-------------o---------oM-B-EE-----M-----?----------o-------E---M----o----------o------EE----E------?-?----EB---o--B------M----B-------------o--E------------
--B------B-B------------------B---?-o--------------o--o?-M-------E-o----o----------M--Eo--------Eo---------EBB----M--B---?---?o--E--B-E-?-----B----MooBMM-----------o--------EoEB-?--M--?---------------
----?----M---B?----------M----B--o----E-E-------------------?-----EM-----o----E-B??----BB-----?B----------??M-----------ME----B--B---o-----ME---o-EE----?---oM-?----E--EB---M?-?-----?--E----?----------
------B--|-----------?---E-B----B---?-B-?o----------BMo-?--------B-----B---------?--E----------M-E--B-----o-------------------o-B-------------------?-----BB?---------M----------o-----B-o--------------
-B-----o-|---B---------o----B-------E--o-?-E-E-o-E-Mo---o--E--E----o--B--MM-o----------Eo?---?-M--B-Mo-----------------o------E------o-M-----o---------------------------??----------B-----EoB----------
---------|-----?-------------o----------o--------B-M--E--E----------?------M?-E-o---M-----B---------M--------B----E--------------M--M----E----M?---------------B------?----------o---------------------v
----E----|---------oo--oB---?----------EB-----E--E--oME-------E-----M---------------??-------M----------o----Mo-------E--E--------B------------E---------Bo--M------------?-----o-----?----|o----------f
--M?-----|------E---B--B------------------------?---M--o-------B-M----B-E---MM-----M--EM-o-----M--M-B-----------------------?----B-----M---EME-Eo--?--?M-----EE-B---B----B--------?--o--BB-|-----------f
---------|---MXE-------------M----?EE-?-----Xo-o--X-E---------BE-o-?oE--o-oB--T?-----E-----E--BEE-----E??B----------?-----EoB-----TB-o-o----E--o-M--E--oM-----------oB--------------M----M-|BM---------f
-M--o----|-M-E-?--M-MM-----M-----TB----M?X-X?---EX-B--o-M----XE-X-o---------E-|-E--?B-----?--o-o---E-?----MET?--?o-|-----M------?E|-------Eo--o--------XX-o???-Eo--M-B?o----?---M-M-TB-X-XE|-----------f
-----M|--|----To-------XB-------E|?----BBXB-T---X-?-B-|---E--oXX---o----?---o-|-----T-------TBM----o----|---|-----M|--o-X-Mo|-B?M-|ME--o-----o-XX-M--|--?------M--M?XX---o-|--E--EM-|---X--T?----------f
--|---|--|-|--|--------BX-|--T?--|--X-ToXM--|-B--X?-To|--MEEX--X|-|--XB-TE-X-?|--TEE|-M-|--B|--|--EX||-o|---|-T----|-ET-|-T-|-T?T-|-|-TET|----T-EX-|-|-??-X----o-?E--|--TTB|-|-T-E-T|-|-TEX|-|---------f
m-|---||-|-|-X|||--|-|-XoX|EX|---|--XX||-|--|-XE|-XB-X-EX-E|-XX-|-|-XX|-||-X|-|-|||-|---|-|-B|-|--X-|||-||--|-|-B|-X|-|-|-|-|-|-|-|-|M|-||--|-|--X-|-|-|-|-XMXB|-o|-o|??||--||-|-|-o|-|-|-X|||---------X
XXXXXXXXXXXXXXXXXXXXXXXXXXXXXXXXXXXXXXXXXXXXXXXXXXXXXXXXXXXXXXXXXXXXXXXXXXXXXXXXXXXXXXXXXXXXXXXXXXXXXXXXXXXXXXXXXXXXXXXXXXXXXXXXXXXXXXXXXXXXXXXXXXXXXXXXXXXXXXXXXXXXXXXXXXXXXXXXXXXXXXXXXXXXXXXXXXXXXXXX
