-----------------------------?--------------------?----------------------o-------------?--------------------------E-o-------?-----------------------------------------------------------------------E---
---E-----o----------E---E------------------------------------o------------------------------------------?-----E-?-E-------------------------------------------------------------------------------------
-------------------?-----------------------------?-?-------------------?-o--------?o---------------------------E-----------?------------E------------------------------?------------------------------E-
--------------------?---------------------?E-----------?--o---E-----------?----o?------?-------------E-------------------E-?--E---E----------------------E--o------------?--------?E----------E---------
----------------?-------E----------?-----------------o---?-----------------------------?--------------------------?---------------E-------Eo------?-------------------------------------------?---------
---??---------------E-----o---------------------?----------?----o---------------?---------?------------?--------------------------------?--------------------?-----E----?----------------E?-----E-------
------------?---------------o---E-------------------------------o---?-?---------?---------------------?-o-------------o-------------------------o------------------------------?-------?-?---?----------
------------------------?--------?----o---------------------------E?------------E-----?-----------E-?----E----------------------o-----E-------?-------------------o-----------E----------E----------o--v
-------------------o-----?---------------?-------------------------------------------------o--?----------?----------------------o--------o--------------E---------?-------------?-----oE--------?E----?f
------?--------------------?------------------?-------?---------------------E-----------------------------E------o--------?--o------?--------?-E---o-------------------------------------?-?---------?-f
---------------?------------------------------------o---------?o-------?------------------------------?-----?-------o------------------------------------E-------?-----?----o-----------??-------------f
------?-o-----------------?----------o-------------------?----o-?--------------------------------------------------------------?-------------------------?-------o---------------E?-------------o------f
---?----------------------------------------E----?------o-------------------------------?------------E--------E------o-----o---o-|----------o-o------------------------o--?--------------E-------------f
--oE---------o--------o---?--?----|---T-?T-o-----?------|E|-----------------------------------------------?E-----------|------?--|--o-----------?----?E------------o---------?------------|---T-o------f
m||-----------||--?--|--|---|-----|--Eo--|?|-|---------||-o----------|----|------|----E----|---o-------------o---------|----?-E|||-|--|--------|-----|--|---?|--------?|?--||-------?----||--||-|------X
XXXXXXXXXXXXXXXXXXXXXXXXXXXXXXXXXXXXXXXXXXXXXXXXXXXXXXXXXXXXXXXXXXXXXXXXXXXXXXXXXXXXXXXXXXXXXXXXXXXXXXXXXXXXXXXXXXXXXXXXXXXXXXXXXXXXXXXXXXXXXXXXXXXXXXXXXXXXXXXXXXXXXXXXXXXXXXXXXXXXXXXXXXXXXXXXXXXXXXXX
