--------------------------------------------------------------------------------------------------------------------------------------------------------------------------------------------------------
--------------------------------------------------------------------------------------------------------------------------------------------------------------------------------------------------------
--------------------------------------------------------------------------------------------------------------------------------------------------------------------------------------------------------
--------------------------------------------------------------------------------------------------------------------------------------------------------------------------------------------------------
--------------------------------------------------------------------------------------------------------------------------------------------------------------------------------------------------------
--------------------------------------------------------------------------------------------------------------------------------------------------------------------------------------------------------
--------------------------------------------------------------------------------------------------------------------------------------------------------------------------------------------------------
-------------------------------------------------------------------------------------------------------------------------------------------------------------------------------------------------------v
--------------------------------------------------------------------------------------------------------------------------------------------------------------------------------------------------------
------?---o------o---XX---?EXEX-X-EX---------XXXEo--oX-E---?-XX---?XX-X-X---o----?o--XX---??---?-X---o-E-?Eo----X-X?X-?------XEX-?--?-E---X----o?X?------E-o---?---o-?---E-----XX-XXE-?--???---XX-XE----
-o----?--E-o------X?XX---o-E-XXXXXXXE------o--XXE--?--X-----?oX---EXXE-X--E?EX------XXoE??----?EXX-o---E---?-XXX--X-XE--------X---E----?---Xo??-XX--------E-------?-----?-----XX--X-E---o---E--?XX-E----
------?-----?----XX--X-ooo--oXXE-X--XXX--?-o-o-X-X-----X-???X-X---?X--X-X---X-?-X---XXX-?--?o--XX--o----E-?---X-?-?X--?-----?X-E----?--?----X?--X-------?--?----X----?----o---Xo-EXX----o?---X--X----?--
------?o-?---E--XX-XEXXX---?--X-X-?-?X--??--XoX-XX--o-?X-?-E?X-E-E--X--X--?X---oXXEX-X----o---XXXo---E?---?----X---X-X-?----X-X--EXX--E------X-X--------XE-o-----Xo---??------X---Xo-?--X-E--?XXE-------
---o?X?----o-----X?XX-X------o-X----X-X--?---XXXXE--??X-XE-?XXo--o-X---X-oEXX---X--?Xo?-X?E----X?-?---X-?--?-??X----X-?E----XX---X-X--------?-X----?-o--Xoo---oo-X---Xo---??-X?o?--XX----X-?---XX--XE---
m---X-XX-X-X-o-o?XX-?Xo-o?---XX---?--X?--o-?-EXXXX-?-XX-X--X-X?X-?EX--X-oo--X?XXX---XX-XXXXo----XXoX--XX-?-X?-X-?-XX?-XE??oo?X?X?X-X---EX?E?-XX-??-?-----X-X-o-X?XX?-XX-----X-XX---XX-X--X-?X---XE-oXE--
XXXXXXXXXXXXXXXXXXXXXXXXXXXXXXXXXXXXXXXXXXXXXXXXXXXXXXXXXXXXXXXXXXXXXXXXXXXXXXXXXXXXXXXXXXXXXXXXXXXXXXXXXXXXXXXXXXXXXXXXXXXXXXXXXXXXXXXXXXXXXXXXXXXXXXXXXXXXXXXXXXXXXXXXXXXXXXXXXXXXXXXXXXXXXXXXXXXXXXXX
