--------------------------------------------------------------------------------------------------------------------------------------------------------------------------------------------------------
------o-------------------------------------o-------------------o---B-------------------E----B------------------?------B--------?--------------------------M---------------------o----------------------
----------------------------B-------------------------------------------------------------------------------------------------------------------o-E-----------B-B----B--------------o------B------------
----------------------------------------------------------------------------------B--------------------------------------------------------------------------?---o----------M---------------------------
--------------B----------------?---------------------B-----B-------------------------------------------?-------------E-----o-------------------------?--------------------------------------E-----------
--------------------E?--------M--------------------------------------------------------E--o--------o---------?----------------------B------E-----------B-----------------------------------M------------
------------------------M-----------------------B-B---------------------------M--------------------------?-X------------------o----------------------?---------------?----?-----------------------------
--------------------------------------------------------M-E-----------B--B-o-M-----B------------------------X-----?---------o--------------------------------------o-----------------------------------v
--M---------X------------------------------M---X---------------------------M--X?-B---------------------?-----X-----------------M-------X--------X-------X--------------B--------B-----------------------
---XXoX----XX--?--E-?-X-----E----o-XX-?XXEXXX-X-EX-XX-XX?X----EX-?-X??--X?--EoX---?--X--X-XX--oXXXo--?-X-o-o-X-X-----X---?-----oXXXXB-X?-E--X?XX-------XoEX-X-??------?-----------EXXXXX--oXX---E-------
-?o-XXo----X?XX-?oo-X-M?----X-X-E-ooXXXX--XX---XXXoX--?X-X------X--?BBBo?o---X???-??--XXo-EXE---XX?----XX--BEXoX-o----E?-?-----??XXoXX----XX--X-------X-?E-X-o------M--???---------XXEX-X---Xo?-X--o-o--
--X-X-------X-X--XX--XX?-----Xo???-XXXX--?-oXo-?X-X-XXXXX-E-XE--oXXXXXXX--???-Xo-o-?---XoXXoX----XXX---Xo---E-XXXXXE-?EXE------X-X---X?E--EX-X?------o-XXXX-Xo-?-?-----?----------X-XX-?-X---X?--XX-----
--o-XMEo-?E-EX-Xo-XXXX---------X-X-X-XE?E--XXX--XXEX?X-XXo?oX-oo-X--X-XXX--E-XX?-o---XEXoXXXX-?--XXX--E-X?-E-?EXX?X---X?o--o-B--X-XXX-EXXXXXX-------o--EXXX-XXXo-?-X??-----o---EE--X--XoX-Xo--X-?-X-M?--
--XX?--E-XX---X?XX?XX?o----??-X-X-XX?-X-o---XX---XX-EBX-XoX-X--XXM--X-XXXXEE-?X?----XXXX-XB-X--XXXX----X?XX-XXX-XXX-?--Xo?E---?--XX-X---o-XX?--o-E--X--?XXXX-X-XEX-?XX----?X?oo-E-o-oXo-?XX?X-XXoXX-X---
m--X--X-X-XE--EX-XXX?XX?E-XE?o-X-XX|X-X-XX--EXXXXEXXX-XXoXoE-XXXX-XXoo-XoBXXX?X-?o--?X--Xo-oX-XX-X-B----X--XEX?--XX?|EXX-o-X---X-XX-?X|XXXX---X---o-XXXX-oX?-XX-o-X-XXoXXXX-?XXXX-XX-X??--XX-E-XX-XXXX--
XXXXXXXXXXXXXXXXXXXXXXXXXXXXXXXXXXXXXXXXXXXXXXXXXXXXXXXXXXXXXXXXXXXXXXXXXXXXXXXXXXXXXXXXXXXXXXXXXXXXXXXXXXXXXXXXXXXXXXXXXXXXXXXXXXXXXXXXXXXXXXXXXXXXXXXXXXXXXXXXXXXXXXXXXXXXXXXXXXXXXXXXXXXXXXXXXXXXXXXX
