--------------------------------------------------------------------------------------------------------------------------------------------------------------------------------------------------------
-----------------------o------M---------------------------M-----------??------E--------M------?-----------------------B-------------------------M-------E-----------------------------------------------
------B------------------o-------------------------------------------E--------E-------------------------------------------------M------?-------------E----B-----o---------------o-----------------------
---------B---------------E---------o---o--------------B------------------------o------------------------------------?--------------------------------------E--------------------------------------------
-----------o-----M-B----------------B--------------------o-----------------------B-------------------------------------------------------------------------------------o----------------------o-B-Eo----
-----------------------------E---------B-------------------M--?-----------------------------B----------------------------?---------------------------------------------------?----------------------E---
-------------B-----------------------------------------------B----------------------------------------------------?--------------E------------------E----------------------------B----------------------
---------------------------------E-----------------------------------------o--B-------------B--B----------------------------------M--------------------------------------------?--E-o--------------B---v
-------------o-------------------------E---------------------Xo----------------------------------E--------------------?--------------------M----------o--------?----o-----------------------------------
---------------E-B-B-M------o---o--X-o-----EBB?----M-?----M-oXM----Xo?----M----?-B-EM--o---o-B--o-oMB--E-M-B-Mo-------------E-BE-----B--?-E-M--X----o-?-B---Mo-EX----B-------?E--E---------?-MMBB-------
--M---E?---o----E--?----oM----o-M-X??oMEM-------Bo-----------XM---X--------M-o------------Bo------M--oMB--o-------BE?-o--oo?---o-----E--E?----X--E-o-----o-o----X--?MoEE-Bo---?---------M-----BX-E------
-o------?M-o--?------------EEM-o---X-X-X-?---M-----M---o---BMXoM-X?M------MEM----?---X-o-B----?-?oX-?------------EB-----XX?-M--?--EX-X--o--oB?X-------BB--o-EMXX?-BX---o--------------B-E---X-X-X-B-M---
--?---o--E-----o---E--M-o-E----------XXo-M--o-M---XEB--Bo---X--X-X--B-EoB--??-M------E--M--E--?M-?X-E-BE-------------BBoX------XX---X-EM---o--X-o-EM-----o---XXX--X---o-E---?B-M--M----X--XMXBX-Xo--M---
----?--XX----o---o--oo-X-X-?--------B--oX-M-B?----X--?------X-----M-B?-XEXo-E-E?--oEX--B??-B-MX--XXX--X-?TB?M---B-B-M--X-EBE---X--?-X--B----oX-----?----?-----o--EX-----M---B-M--B-M?--X-X---oM-XX------
m--Xo?-XX-----E-X--o-XXXX--X-M?--X---X?X-------E--XX---?-X-XX?-EXE?-XX|o-----o----XXX---XE-?---X??XXBMXXX|---------?-EBX-X----X-XEXX-B?-X?---oXo?-o--?E---o-MoX-XX----XX-----B-----EXXX-XX-o--XBX-XMo---
XXXXXXXXXXXXXXXXXXXXXXXXXXXXXXXXXXXXXXXXXXXXXXXXXXXXXXXXXXXXXXXXXXXXXXXXXXXXXXXXXXXXXXXXXXXXXXXXXXXXXXXXXXXXXXXXXXXXXXXXXXXXXXXXXXXXXXXXXXXXXXXXXXXXXXXXXXXXXXXXXXXXXXXXXXXXXXXXXXXXXXXXXXXXXXXXXXXXXXXX
