--------------------------------------------------------------------------------------------------------------------------------------------------------------------------------------------------------
--------------B------------------------E----------------------?--------------------------------------------E------------------------------------------------------E-------------------------------------
------------M--------------B-------o--------------------------------------------------------------------------------------------------------------------------------?--o----?-----E-----------------B---
-----?------------------------?-------oo---------------------------?------------------------------E--B-------?-----------E-------------------oE-------------------?--------B------------?o--------------
-----------B--B--------------------------------------------------------------------------------------------------------------------------------------?-------M------------------??M--------------o------
---------------------B--------------------------------?-------------------------------B-------------?--------------?-B----------------------B-----------------------------------------------------------
-----------------------------------?-----------M------------------------------------------B------o-------------------------------M-------------------B------------------------------o-------------------
---------------------------------M----------------o----------------------------------------------B-------------------------?--------------------------------X---------------------------E-M-----------?v
------------------------------------------------?----------------------------------------------X-------------------X--------------------X-------------------X----------------------------M---E----X-----
--E----E--?-XX--XXX-X----o---X-E?BB-----?------B---M-?-XX--------?XX-X---?--------EBE--X-X----XXo-X--------?-X------X?-M-------??--?-X-X??----o-o-E?BB----o-XEE--XX-X--?----?---X-X-o------X--X--X-XoX--
-?E--------X?-?--XXX-----Eo---X-X----E------?--X----E?X-X-------?oEX-X---???--?XX---XoXEX-?---EXXX-------?--M-X-?o---X--------------E?o-X-EE--M--------------X-E-oX-XX---?-?-E-?XX-----EE---XX-XX-?-Xo--
---E----E-?-X-?---Xo---o-X-XE-XX----------o---X?-----X-X--------?-X-XXE---o-?--X--XXXXXX--E---BX-XB------?---X?--M------?-?-?--E----XXEXXX--E-------???-----o-X-X-oX-X---?-E?-oXXX----?--?--X---XX?X----
----o-Eo?-XX?XXXXME----?XXX--XE?X--E--------oX--XX--X-X---XE-----X-E-XX-----E--oX--XXXX?--X-E--X-X??-?-?--E---X---B----E---oX?---?-EXXE-XE------oE--o-------?---MXETX-----?-----XXX-------?--XoXEX--X---
-----?-E?--X--X-XXX--X--XX--XX-X??---MM-E-XXXX?E-XX-EX-?-X-??----X--XX-T----?XX---?-Xo-Xo--X---oXXX-X-o---X?X--XX--?-X--X-EE?---X---XXo-?X-T?X--Xo---o--E-??-XXX-X-|-----EE--XEXMXX-----o-----Xo-XXXX---
m-o--X||--XXM-XoXX?XX?-|XX?M-X-X?X--o-oXX-X?XXXEooX-X---Xo----|-?|X-X-?|?-oXX-X-?oo----X|--X-?---XEXXX---?-X---XX-E?oX-X-?-oXX|X--?XE-X----|X----?--X|o----XM---X??|?X------B--X-X?--o?---E-M-X?XXXE-X--
XXXXXXXXXXXXXXXXXXXXXXXXXXXXXXXXXXXXXXXXXXXXXXXXXXXXXXXXXXXXXXXXXXXXXXXXXXXXXXXXXXXXXXXXXXXXXXXXXXXXXXXXXXXXXXXXXXXXXXXXXXXXXXXXXXXXXXXXXXXXXXXXXXXXXXXXXXXXXXXXXXXXXXXXXXXXXXXXXXXXXXXXXXXXXXXXXXXXXXXX
