---BoX-----M---------------M--XEE-----------------EMB------B--------?-BB--Xo----------------------?--E-----------o-----X-------------B--------------o---------ME---X---EM-----------------------?-------
----B---X---------E--------E---B-----??M--------o---B-------?-----o-------E--oB--------------X----------X--------------B-M--?E-E--------------E----E---B------M-----B-M--------------o---------EX-------
-------?-------------------------E---------B--------X---o----?-----------M--------B-?--Bo-E--B--------------o--o----B---o?M------X------X---B--?--?-E--E--------?---------------------------?---M-------
--------o--B-----B--MB-o-----E--XEB-BE-?--o-------------M--EE---------E------B---B---o---------------?----------E-------X---------------E------oM------?----E-------EE---M----X------E-------E---MX-M?--
----X----------XoXM-----------------------?E--o-----?------B-B------------------X--B---M-X---------B-M--E-------------o---o---o---M---E-----------------E-----X--------------E---?----------------------
---?----B--B-?--------------o----------------B------E-------E----?-------B----o--X-----B------?--------------B-----E-B----M----E------------?-----------X---X-B--X-------MB---E---?---X-----?----?------
------M------------------o------------EB----X---------X-B--o--B--BE--E-?-?-------------E----------------------?---------o------------M-E-----E----------B---------E----------M--?B----oB-------------X--
--E----M----E-?----o-----------M---------------------B-------?--B-o----B------------X---------M-----X-----------M-----------E-----?----E---Eo---X-E--X-----E------------o---E-E--BE---B---o-B---B--XB?-v
--X---------?-B-----?-?----------M?----------------------M----Mo---X--o-o-------M----------M-------?--------B----------------------M--o---?-E----X-E-------ME--X---X-M--M---X-------X-o----EE---B------f
-------------------E---------------------------------------X------?--------M----M?------E------EE---?----X---?-o----------EEX---o---X--M---o-----------E--E---------X-B---M---?o-----E--EM-------?BM---f
----------------EX--E----------M------B-X-----o------------o---MX----B-o-------------------E--E---M-X----BE-------E-X---o-o---------------X---------------------B-o?-o----EE-M--E---?o--X------o-------f
---M---M-E-M-B-----E-B-----M--------?--M-----o--?---X---X-XX------------B----------------X---B-oE-----o---------------------E-----------X--B-------o----B-------o-oB-?--E--o-----------X-B-E--------E--f
-------X---------------oE----------------X---------X?E--?MB-X------B--M---??M---M-------B---------------E-----------X-----Bo-Mo-----------?------MM------o----------------BM--------------------E--E---f
----E----------------------BME-------o------------X------o---B-E--?o---------------------------o-----------?---o---------------------E----X---X-?-----------E--------?---------------X-o---M--------o--f
m--------|----X--M----X--------?-------o-----B-----------------|--o-------XE------B--------------?----?--M--E----------?--X|-----------Mo----------------B--M--------------X|E-EB-E--B-------X---------X
XXXXXXXXXXXXXXXXXXXXXXXXXXXXMXo-XXXXXXXX-XXXXXXXXXEXXXMXXXXXXXoXXXXXXXXXXEXXXXXX-XXXXXXXEX?XXXXXXXX-X-BXXXXXXXXXXXXBoX?XXXBoXBXXXX?XXXXXXXXXXXXoXXoBoXXEXXoXXXX-XoXXXXXXXXEXXXXXEXXXXXXXXXXXX?XXXXXXXEMX
