--------------------------------------------------------------------------------------------------------------------------------------------------------------------------------------------------------
--------------------------------------------------------------------------------------------------------------------------------------------------------------------------------------------------------
--------------------------------------------------------------------------------------------------------------------------------------------------------------------------------------------------------
--------------------------------------------------------------------------------------------------------------------------------------------------------------------------------------------------------
--------------------------------------------------------------------------------------------------------------------------------------------------------------------------------------------------------
--------------------------------------------------------------------------------------------------------------------------------------------------------------------------------------------------------
--------------------------------------------------------------------------------------------------------------------------------------------------------------------------------------------------------
-------------------------------------------------------------------------------------------------------------------------------------------------------------------------------------------------------v
--------------------------------------------------------------------------------------------------------------------------------------------------------------------------------------------------------
-------??---XXXXX?-----E--------X-?X-o?-?----o-?E------------XX-E?--------?--?---?---X-o-o---E-----E---EXX?-E-----------?------?--o------------------------?--E------?----?--Xo?-?-X---X-------?-?-?----
-----?-EX----XE?X?--E-------Eo-EXXXo------E--E---EE-----E??T-X----------?-------------X-?------E------E-?X-X--?---oE--??o?-o---E----------?---X--E?-?-----------?-------?--XX-XXX-XX---X---?-?----------
---ooE--X?XX-X-X-?------?---?---oXXX-----------?-o--o------|XEE--E--??E---E-----o----XX---??------------?XXE-----E-o---------------?---XX?EX--X--?---?-------------E?------XXE-X-?-XXE--X-X-??E--X---X--
--o-T----XX-o-X|---?-------?--?-ooX--------?o?--?oEXXX-E--?|-XT---?--E?--X------X?oE-X-X-X?X----------E--XXE-E--?----?---?--?-??---XE??-XX-X-Xo-E-?-?--o---------?----E--E--XXX---XoX----X---?--X---EX--
--T-|o-o--X---X|-------?----XX----oX---?-T??X--?XX?-X|-T-oE|X-|E---?----TX----|-X---XX--X-X-?---?-T-o?XXoX---?-E-----|----ET-?--?-T?X--??XX??X--?--?EX---?----E-?-E---?-T--|XXX--EXX-E---X-XXX-X-XX-X---
m?|-|--XXXX---X|o?-E-?X?EX-XX---o?X|oX---|XoXXX?XXXX-|-|XX-|X?|E---X|?-X|-X---|oX-X-XX---XX-X?-?--|--XXXXo-----|---?-|X?oXX|X|X-|E|XEX-X-XX---X-XX?-X|--X-?-X---X----X??|-?|XX----EX-XX?-XXo-X?-XooX----
XXXXXXXXXXXXXXXXXXXXXXXXXXXXXXXXXXXXXXXXXXXXXXXXXXXXXXXXXXXXXXXXXXXXXXXXXXXXXXXXXXXXXXXXXXXXXXXXXXXXXXXXXXXXXXXXXXXXXXXXXXXXXXXXXXXXXXXXXXXXXXXXXXXXXXXXXXXXXXXXXXXXXXXXXXXXXXXXXXXXXXXXXXXXXXXXXXXXXXXX
