---?---?---E-------M-------M---o-------------B----M--------------------o-----?---M-?-E-?------E----?-BE?--?B--M----o--M---M----?---E-?----M-----------o-----?-----oM-B--o-----------?-E--?--E?--------B-
-M--M--o----------?--------B-------??----------o-------EE------?--B---------o----B---?---?------------B----o-o-Mo---BMoB----------E-------------------B---B----------------------o------M-------o--o----
-------?-?E-E--E--oo-----?---------E------o-E---------E-M--------B--o-------o-----------B--B----------?-M-o--B-----------------------------M-EB----o--o?---B---o-M--------------E-----?-M----?------M---
----M---------?-M----??-M-o------?------E-?---?-------B-------o-------E--------------------M--M----E-?-B-oM---?-----------------B-?-B--------E-----E--B--?----------BoEEoM--?--------E------M-?---?-----
-?o--------------?---EMo----?-E--M-?E-E-------------o--------E---B?---------B---------o-----B--------o--------E---------------MM----?-E--E-o-------M--------?-M------o-------E--------BE---E----------B-
-M----BBo-E-EM----------------o-----E?--MB--?-------E----------?---o-M-?-------------B----M-?--MBM------EoB--B-Bo-------E--Bo--?-B-----o----B-BE--?--E---------??--E---M-oM--o-------Mo-M------------?--
--Eo-M---o-------?-------B--M-B--------?B-----M------o----M----?--?------B----EB----M--B--------M------E--------------M-----o-M------?-M----M-o-------?B----------o-----E--E-------?---------B-----B?---
--o---M---?--------------BB-E---------E----o---------------B---?---------E--E?-----------o---?-----o?-----o--M--M---------------------------?-----ME------E--?-------o-----o----?---o-o----?-------B---v
-----B-----------------?-B?-o---------??-E---B--------M?------B---M-------o----------o------B----B-------M--o------------??--------o----B-----------BMM---------?---M--MB------M-----B---M--BE---??---of
-o---B--------o-------M---------B---E--M---B-------E----------------M-----------------------M------------o-o--?----BEB-o------------?---------?-M------?-----o-------?--------------?--B-E-----------o-f
----------o-------o---M-----------------Mo-------E-------Eo-E-------B--------E--??-??---------Eo--------?------M---E------------o--o---?---?----M-------o-M------M---------------o--B-------------B----f
---?--E-B----B--E--o-------?---?---B-------------------B-------------M-------------oE--------o--?----o---------BB-----?----BB--B------------?--o------------------------?B----o---M--M---B?--B---?-M-B-f
----oB----?------E----o--------E----B-EB----M------E------------MEB-o--M---------------M------o-----B-?----o-------------E--o-M-o-----?-----------M---------M--?o?----------------------?----?------B--f
------------B-?----------------?-B--------oo--M----o-o-------M---------B--------------M---------Mo----M-----M-----o----?-?----?-------M?-E--?-------?--------E----M------------B-E-MBE-B------o--------f
m-X----E---------BE-------E---------M------------------B-|----E-o--?-X-----------------B---|----E-XE----B----------B--M----o-----E-M--|-----------|-X--------|---M---|--o-------------|--?B?--------X--X
XXXXXXXXXXXXXXXXXXXXXXXXXXXXXXXXXXXXXXXXXXXXXXXXXXXXXXXXXXXXXXXXXXXXXXXXXXXXXXXXXXXXXXXXXXXXXXXXXXXXXXXXXXXXXXXXXXXXXXXXXXXXXXXXXXXXXXXXXXXXXXXXXXXXXXXXXXXXXXXXXXXXXXXXXXXXXXXXXXXXXXXXXXXXXXXXXXXXXXXX
