--------------------------------------------------------------------------------------------------------------------------------------------------------------------------------------------------------
--------------------o---?--------------------------------B--------------------?------?--------------------------------E--------------------------------M--B---------------------------------------------
-----------------------------M---------?----------------E------------------?-----------------M----------------------------------------------------------------------------------------------------------
----------------------------------------?----------E---?---------------------M----------------------M---------------------------------------E----------B------------------------------------------------
------------------------E----M----B-----------M--------------?--M-------------------------------------------------------------------------------------B---------------------------E-----------E---------
-----------M---------------------B------M-----------------------------------------------------------------------------------------o-----?-----B--------------B---------B-----?-B------------------------
-----?---------------------------M-------------------------------------------------------E--------------?----------------E--M---------------------------------------------------------------------------
------MB--------------E----M------------o---B---B----------?-M--------------------------------------------o--?----E-------------B-------------M------o-------------------------------------------------v
--------------E--o---------------------------------------------------E-------------------------------o---------------B------------------------------------M------------E-------------------------?--?---
----M-----EB-------?E--??-------?B-?o-------------?----B-Eo--?-----------M-----?--?-M-MBo?---E---ME----EM----B------?--BEBoEBM--?----M----------o--?--MM--o-o-ME--X------M-----ooBBo--E-MXXo-------E----
-----------------X--EB---ME-----B-?-----?----EoM---M--o---------------?-oo--oo---oE?B--?-B-------o-o-------M-----o---M-----B--B-?--?--oBE-EEB-BM-E-M---------M---X?-----B-?MBB-?---------X-?--M----o----
-M--B-BE-------B?X--o?o-----E-B-------o---E-E----??--E--E-E--B--E-----------------o------oB-------EM--M-?XXX-EE--B---BXE------------------M-B--B----------?--o--X--------?E-----------XM--XE--ME-o------
-----BX--E-E----X-o---M----?-B------oo--M---Eo-M--------M--B-----X-----BE---o-?X?X-----oB?----E----Mo--E-o-X---o---M-X----B?--------E---Boo----XE---EBE---------X--M--?B----------B--E-X-X---X-------?--
----X-XE--X---oXXB----o-EMMME-BB--B-M??-B-o-o-E-------XEXX-M----?-XB?--oo-M---X--XXX-B--??E--X-ME--------XXX--M-----Xo--o---X--E?MB-----B--B-MX-M---X--E--o-MB-XX------?----?--B-BoB-M--X--XXo-T-o--T---
m--X-B-X-X-Xo---X?----B-XX----M-XXE?-X-B--EXX-Xo---oE-oXXo-X-XB-?|XX-X--E-X?---X-X-X---B-M---Xo-?-----o-XMX-XE-X--BX-XB--X?-Xo-X----?-B?E---?X--XE-X-EoX-X--XEEXXE--XE--X-?M-oXX-Mo-XM-XXX-X--o|XBXB|X--
XXXXXXXXXXXXXXXXXXXXXXXXXXXXXXXXXXXXXXXXXXXXXXXXXXXXXXXXXXXXXXXXXXXXXXXXXXXXXXXXXXXXXXXXXXXXXXXXXXXXXXXXXXXXXXXXXXXXXXXXXXXXXXXXXXXXXXXXXXXXXXXXXXXXXXXXXXXXXXXXXXXXXXXXXXXXXXXXXXXXXXXXXXXXXXXXXXXXXXXX
