--------------------------------------------------------------------------------------------------------?-------------------------------------------------o?--------------------------------------------
------------------------?----------------------------------------------------------------------------------------------------?-----------o----?---------------------------------?---------E-------------
-----------------o-------------------------------------------------------------------------?----------------------------------------?-------------------------------------------------------------------
----------------------------------------------------------------?-----------------?-----------------o--------E---------E-----E-------------------------------------?------------------------------------
-------------------E-------------------------------------------------------------------------E---------------E------------------------------------------------------------------------------------------
-----------------------------------------------------------------------------------------------------------------E----------------------------------E----------------?----------------------------------
---------------------------------?-------E-------------o---------------?------------------------------------------------------------------------------------------------------------------------?-------
------------------------------------------------?-----------------------------------o------E--?-?-----------?---------------------------------------?--------------------------------------------------v
----?-----------?---------------------------------------?-------------------------------------------------------------E------?-----?---------------E-------------------------?-------------------------f
-------------------------o-----------o-----------------------------------------------?---------------------------------------------------------------E-----o-----------?-------------------------------f
---------------------------?------------------------------o--?--------?---------------------------------------?---------?-------------------------------------?-?--------------------------------------f
---------------------------E-?---------------------------------?---------------------------------------E-----------E-------------------------------------------E----------------------------?----------f
-------?--------E---------------?--------?---------------------------------o----------------------------------------------------------?--------------------------------------------------E--E----------f
---------------------------------------------------?-------------------------------?-----E--------------------------------------------------------------------------------------------?----------------f
m|------------|---|--------|----------|----||--------------------?---------------|----E------------?------------------|----------------------E--------o------|----|---|-----|--|-|-----------|-|-------X
XXXXXXXXXXXXXXXXXXXXXXXXXXXXXXXXXXXXXXXXXXXXXXXXXXXXXXXXXXXXXXXXXXXXXXXXXXXXXXXXXXXXXXXXXXXXXXXXXXXXXXXXXXXXXXXXXXXXXXXXXXXXXXXXXXXXXXXXXXXXXXXXXXXXXXXXXXXXXXXXXXXXXXXXXXXXXXXXXXXXXXXXXXXXXXXXXXXXXXXX
