--------------------------------------------------------------------------------------------------------------------------------------------------------------------------------------------------------
--------------------------------------------------------------------------------------------------------------------------------------------------------------------------------------------------------
--------------------------------------------------------------------------------------------------------------------------------------------------------------------------------------------------------
--------------------------------------------------------------------------------------------------------------------------------------------------------------------------------------------------------
--------------------------------------------------------------------------------------------------------------------------------------------------------------------------------------------------------
--------------------------------------------------------------------------------------------------------------------------------------------------------------------------------------------------------
--------------------------------------------------------------------------------------------------------------------------------------------------------------------------------------------------------
-------------------------------------------------------------------------------------------------------------------------------------------------------------------------------------------------------v
--------------------------------------------------------------------------------------------------------------------------------------------------------------------------------------------------------
---E--?-o------?--XXX?---XXE-E--X?-o--X--?-X--?--?-----?--E-?-------------?--------?--XX?---o--?E-??--ooEX-?-----E------?---XX?-?---------E---E-o------X--X-----E---------XXX--o---XXE---o-?-E??-----?--
-oE--?-o----?-?--XXXX?----X?---XXXXX---X-XX-----oo--o---?------------o-----------Eo?-?-X-------------?---XXX-----E-?----o----X-E--??---------?XEo----X--XX--o-----------X-X-X-----X--X?-------E----?E---
-------X----Xo--oX--X--?--oXX?--X--XX---X-X-------XX-?-E------o---E---?--o-----E--X--XX----------o-??---E-X-X----------X-XEXX-------------E-EX--------XXX----?EE-E----?--X-o-XXXXXE-E-X?-----XXE--------
--------X--?-X----X-Xo-?-??-X----X-X?o--XX--------X-X?o-----------------------E-X--X--XE--E-------X----o---XX------?---oX?-XoX?-------?-?---X-?------?oXE?----??XX--??oXXXXo-?XXX-XoX-X-----?X-?-?------
------?XE-o?-XEo---XX-XXX-oEXX----XX??---X?-------XX?--E--o-o--XXX--o------E---?-X--X-XX?---------X--E?E--o-X--E-------X---?XX---?Xo--?-o?-?oX??-E-?--?-X-o----XX-XXXX-XXoXE-oXX-XXXEX?--o---X???----?--
m-o--o-X--?-XoXX-X-X-E-X---X-X-?---XoX-X-XX??----XoXoX?-X?X?X-X-X-----Xo--X??XXXX-X?XX-?XXXX-XX?E??X-----XXX-E--?-E??XX-E?--X?--o-XXX---Xo-oX----?X?--X-X--??--X-X--X--X--?XXXX-E-XXX-X-?--EX-XXo-EE?---
XXXXXXXXXXXXXXXXXXXXXXXXXXXXXXXXXXXXXXXXXXXXXXXXXXXXXXXXXXXXXXXXXXXXXXXXXXXXXXXXXXXXXXXXXXXXXXXXXXXXXXXXXXXXXXXXXXXXXXXXXXXXXXXXXXXXXXXXXXXXXXXXXXXXXXXXXXXXXXXXXXXXXXXXXXXXXXXXXXXXXXXXXXXXXXXXXXXXXXXX
