--------------------------------------------------------------------------------------------------------------------------------------------------------------------------------------------------------
----------o-E----M?--------------------------E?--E----------?-------------oE--M---------B--------------B-----------B-----o--M--?---E---------?-o----------o-MM-----------------B--?---------------------
----B-----------------o-----E-M-B--?-M-------------E-M-E?o-------------E--------EM--?---E--------o----------o----------?---o------EE-?---------?-?----oB--------------------o--------------E------------
------o-?-B-----?---E---oM------E--M-o--M------M---?----------B---E---------B----?o-o-Eo-----M--E--Eo------E-B-----M?B---?---?o--E----E--o----B--------M-----o-------------------------E-----B----------
----E----------M--?--BE-------E---M-------B----E-B---E---E--E----E------Mo----M--?------BM----------------?M---------M---E?---B--B--?M-?------?oo-E---------o----?--?-oE----B--M-B-B--------M-----------
---?-B?------E---------E-?----B---------?---------Eo-?-----E-B------o--B--o-----------------o-M---o--------?---------?----o?--o-Bo?---BE--M---o-----?-----B-?-?-M-----M-----------E--?---E--------------
---------M?-M-------------o------E-oM---------------o---?-------------M-----?----E-----E-----?------M-M---------------------M-EE-------?-----o---------o--------------------------------Bo--------------
------------------o---------o-o--------oB--------------M--o-----?---?-----------o---M-----B------o--M------M-B?------?M------E--B---E----M---------E------o----B--------E---o--------E----B------------v
---?-M-?--E---??B-----oE--E-o-------------E----M-------|--------?--o-----?-----M-E---B-------B-------------o-Mo------BE------------E--E-E-----------MM---oo--M----------------?-o----B------EX---------f
--?----------M-----E---------------M---o------B-EM-BE--|---E-Mo----o----E---MMo----M--EM-M--------M?B------------B--------------------?oo--EME-E?--MM-?-------E-B---B----B-B----E-E------M---X---------f
---?--Bo-M--E--B--?M-E---------Mo-------o------Eo-E----|---?M--oX-M-oE----oB--o?-----E---M-E-M--------E-oBE----?----------E-------T-E--o----E--o-M--E--oM-------oE-ooB----X--M--M?M----M----o?---------f
-EEE-E-?-o---------B------------|---------?---------ooM|-------oX-o|----o--oEo|-E|-o-B--o----o-----?-B-----ETE----o|---X?M--------To-------o-------M-|--ooo???--oE--XB?o--X--MB??---------B-XX---------f
-----M----?---------o-BEB-MTE---|---EBB|-----|--X-----E|E--XMM-X---|----?-----|--|--T-B-|---TBM----o----T--?|B---|-|-oo-X-Mo--B---|-|----|---o-X-----|--?-----X---M?XX----MX---|--o---?EB---MX---------f
----o--B|-TX----TTT--T|---B|----|-|--XT|-|--E|--|-|-o-X|-TXo-?-X-|M|-X|-TE---?|-T|E-|-o-|--B|--|--EX|--M|---|-T--|-|TET-|-|-|-T?T-|-|-TE-|--|-TB-XX|-|-??-X-XX-o-EE-XX--TTM----|-?E-|-----T-BX---------f
m--|-oB-|-|-|---|-|-E-|--X-||-|-|-|--XX|-|-|-|--?-|---X|-|-B|--|-|-|-X|--|--|-|-||--|--B|-|-X|-|-XX-|--X||--|-|-B|-||-|-|E|-|-|-|?|-|M|--|--|-|---X|-|-X-|-XMXB|-o|-X|--|||-B|-|-|-?|--|--|--X---------X
XXXXXXXXXXXXXXXXXXXXXXXXXXXXXXXXXXXXXXXXXXXXXXXXXXXXXXXXXXXXXXXXXXXXXXXXXXXXXXXXXXXXXXXXXXXXXXXXXXXXXXXXXXXXXXXXXXXXXXXXXXXXXXXXXXXXXXXXXXXXXXXXXXXXXXXXXXXXXXXXXXXXXXXXXXXXXXXXXXXXXXXXXXXXXXXXXXXXXXXX
