----------------------o-----------E-------------------------------------------------o-----------------------------------------------------------------?--------------?----------------------?---------?-
-----------------------------------------o---------------------------------------------------E--------------------------------------------------------------------------------o-------------------------
---------------------------------------------------------------------------------------------o----o--E--------------------------------------------------------------------------------------------------
------------------------?-------------------------------------o------?-------------------------------------------------------------------o--------------------------------------------------------------
----------?-------------?-------------------------------------?---?----------E------E--?--------------------------------?-----------------------------------------------------------E-----o-------------
------------------------------------------o?---E-----------o-----EE-------------------------------------?-----------E------------E----------------------------------------------------------------------
------------------E----o---------------------E------------------------------------------------------------------------?-------------?--------?----------?------o----E---?---E--------?--?---?-----------
-----------E----------------------?--------------------o----------------------------------E------?-----------------------------------------------------------------------------------------------------v
-------------?-------------------o------?--------E--o-----------------------o--------?-------------------------------------------------------------?--------------------------------------------o------f
-----------------------?------------------------------E-------E------------------------------------------------------------------------------------o---------------?-----------------------------------f
----------------------o----------o-----------------------------------------------------------------------------?-?-------------------E-o--------------------------?------------------------------------f
-------------------------------------------?-----------------------------------------------------------------------------------------------------------------?-----o--E--------------------------------f
----------------------------------------------------------------------------------------------------E--?----E------------------------?---------?-----------------------?-------------------------------f
-----------?-------------------------------------------------?---------------------------------------?--------?-------------------------------E-------------E------------------------------------------f
m--|----------------?-----|-----?---------------E--|-----|----------?------|-------------------?------------|------|------|---E---|-E------|----------|-------------------|--|-----------------?---?---X
XXXXXXXXXXXXXXXXXXXXXXXXXXXXXXXXXXXXXXXXXXXXXXXXXXXXXXXXXXXXXXXXXXXXXXXXXXXXXXXXXXXXXXXXXXXXXXXXXXXXXXXXXXXXXXXXXXXXXXXXXXXXXXXXXXXXXXXXXXXXXXXXXXXXXXXXXXXXXXXXXXXXXXXXXXXXXXXXXXXXXXXXXXXXXXXXXXXXXXXX
