--------------------------------------------------------------------------------------------------------------------------------------------------------------------------------------------------------
-------------B-----E--?------------------?------------------M---?-?----------------------------E--M---------o-o---------------o-------?---------M-----ME--------------------------?---------------------
---------o--------B-----------------------------------------M------E-E-------------E------------------B---------------------?-----B--------o------o---------------------------?--------------B----------
----------------------------------------------------------------?-----------M-------------------B---------------------M------o--------------------------------B-------?-M----------------B--------------
--------E---------?-B--------------------------------------------M--------------M--M------M---------------B------B-----M--E--------------------B-----M-----------------------?-B----o-------------------
-----------?--?----------?------?--------------?---------B---------B--------?---M-----o-----------E----o---------------?M-----------------------E-----------------------?-?---E-----o-------------------
-?-B------------------------------------------------------------------------------?---------------------B--------------------------------B-o-----------------M------------------------------------------
--E---------------------------------------------------o---------M--------B-----------------M-------------------B-------?----------B---------------------o-E-------?----M-------------E-------?---------v
---------M-------------------M-----?---------?-----------------------------M-----------X---M-----B--o--------------o---------------------------------------------?-------------------------------------f
-E--M--E--?-o---M---?----?---o-----M-----?---B----E-BMo-----B-o--E-B-------M-----o---M-X?B---EE?----B--EE--------o--M-EoB-BoB-Eo----------B-------E?B--o-B-----------B-------?--XX--?--E-E---B---------f
--------E-------B-M-o---M------??-----o------E-----E--------o--E-EB--------E------M---EX---B-----o-E---o-B-------E---M------B-----X---o--------------oo-?---o??--B--o------------XXXEE-EE-BM-----------f
--oT------?---o-----M-?---E-o--------?--M-B------------E--?----B----------EM-E-----B-?--Xo-------------M------------E-----oB-X?EM-X----B?-o---------B?-M--o?ME?-E----------?------X-X--XX--o-o---------f
---|-BM----B--o--o--X?X-E--B---?-T-B-----TB---?E---B-----T-------?---?-------oB--E?X---E-XXoBB-TT----------o-----T----M-?----o-ooX-EB--o-?TE---X---o--------------B?E---B-E--ME----Xo-EX----B----------f
-ET|?---MX----T-TT---X---B----T--|-|---TB|----?TETT------|o------T-XE---T-M-M---BXEX---o-To---MT|--T-----TTo-T---|-|--B-----?--XXM--TMTT-T|T--EoX---TBXX-BToTM---M---XTM--?----E--MX--TMXTE------------f
m-||----BX--XX|-||--EX-----XX-|--|-|--?|B|--|-X|--|------|B-X-|-X|--X-------B------|----X||----|---|-----B|-X|---|-|---X-XXX----X-----||-E||--X--X--|-X--X|-||----B--X|-----B-X---X|--|-X||------------X
XXXXXXXXXXXXXXXXXXXXXXXXXXXXXXXXXXXXXXXXXXXXXXXXXXXXXXXXXXXXXXXXXXXXXXXXXXXXXXXXXXXXXXXXXXXXXXXXXXXXXXXXXXXXXXXXXXXXXXXXXXXXXXXXXXXXXXXXXXXXXXXXXXXXXXXXXXXXXXXXXXXXXXXXXXXXXXXXXXXXXXXXXXXXXXXXXXXXXXXX
