-?TME---?---TTTEX-o-Mo-|?X-E--ETB-B-BB-?-o----E---M-??-----?-?|M-|?TX-XX-----X----M-----o-?---o------B---|-o--EET-o--M--ooBTBM-B---T-oMEE-M---M?----TE----?o?-o---o--TT---?----T-MX--E--Xo-|T-?-o|--|-E-
-T---X-X----X-----oT-X-TT----T-|B-TT-E---?-X-----|----?o-T-o-?-BoEoX|XT-?----BX?----BBoMoX-?T-?--------M-T?---XEB-E-|--B---o-----T-E--oT-------oo-M?-?||-To-?M-M---MBMM--|----oM?TBBo-ETXM-|Xo-oT-E--|--
--TE-MMM---X-B-B-M-o---Mo---|E-----ME-----BEM--BTTo|X--MXE-XoBX||oE-B---M---ET-|---?-TB-||Xo--B-X-?T---o-M--EME------B--o----XB-o-MX---TMX?-oB---|-o|EEB?|--XM-o?----M--MT-?-o-B--o--M-E?|------?o---?T-
---------|-?---------?-----M--T---M---E---?B--?----oo-B---|-BM|o---MBT--T|---E-|B--B-X---E----T-?M|M-|B--o---T--|-X-M----?TM-ME-X-X-E-?--M--X-|-----Mo---Eo-B---B-BME|----BT-XM--------|---oo?--o?--?MB-
-B--T--|--M--o-B-B-?---E|T--??--?-B|E-B-----o-?o-----?-oB?|-?-o-?-|B--X|----MXM----o?--|--TME---?-|X---E?oT--?M-----?o-BE--To--To--T--BXEET-o--Mo?--T-TM-B-E-M---E-|--------T?-E-|--?M?|E----M-EB-T---B-
--TX-BX?M----?X--T?-|B-B-M-M----EB?EX--|--X---o-|----|-EX?|?--?|BX---X-|----oE-?-B---?-BBE-X--MT?||--TX|M----TBBXE-XB-?-----EE---M-X--E-|-|o-o---|--T||-----o--M-ET-?-TT?----XTTMo-------?MB---TT|-M----
---E---Mo-MXXMMX-o---?--------BB--T----B-o-o--?--oX--------B--B--o---o--ME----MM---MX|--|XMX--|E--BXM?-X---T-----ooBo----M---?E--|------B|---o-o??-M-X----E--------M--||?---M-X-?-X-oB?--|M--M----BT-T|-
-M|MTo-TXE?----MX-?---E---?-E---T---|-oME-ME-M-?E---BEXX-o-M-----o---MT----o?-----X----B-?oo---|--M---T----o--|o--E|XXT---|-E-B--??---|B---X-B?XT-|----|TMBM?--T?E-|-??--|-----E-?--M--?X-TX--X-M-M---|v
-M?-E-o--B-B--------|--?-E--E?----o-X---oM--oM|-ET------oB---|--X--T-|M--ET-M---T?-BX-?---?|-|---oE-?-------o-X----B--o----To?--B-----o-E-M---B?-oTM-EM-oTo---MTX-X-X?oE-X-|---MX--B----o-oE--E---TE---f
-E-o-BoM-XBM--T---X--T-?XMXB-B-M-?X|?-M--BX----M-----oo-o|-oBoM------?XB--?----M--M||o?----X----------MoTo?--|----M---?E--B-o-M-??E|--o?M-?-BXM-------|-M-B-|--B-BM----?o?--oTT--EoTB--TEM-M---T?-MMo-Bf
-?---?----?-?---M-oMETXX------ME-B---o|-E--T----|E-?E--?o--M----T---|M|T--MEME-o--E-B-M-----oTMo--BEM-|X|?o---MT---ToX-E|--|-XE?-?-XX-EE----XM---|--BB--T---E-oBE-M--|----|---o-o---X-----o|-----T-o-TMf
-X--T-------E----X-BT------T------o-?--o--X|-BEM-----EM-?----X----X-M---EBE-M?---TooXBX-----o-MT-----ET----------X-?-|--?o-|-?-B--T-T---EM---B|-|-o---o-M-----o-?--E|--?-E-XoB---|XT-?B?EEoX-|X--oM-TEMf
---BX-E-T---?M---o?-oT-?-T--E?XBM--?-M--B-T------EMTXE---XB--B-|-B-E----E-o--MT--|--|B-X-X?--XM---T--o?MEE----M-M--B-||----E--X?-X-o----EX----T----M----X---T|-?-|------X--XX-XXXo|E|XoM?--X|oBE--ToT-Tf
---------B-X---oB-BEoX--|o--X---|X?E-B--|BMTX----M?M-|??|---?-E--E--MEXX------|X--EMB?-o--XTB?|---oX--B?E-o-o--M-M-?-----BT-T--E-MBXX---B--X--TM||X---B??o---T-?o---M|E-XT--T--??E---|--?-B-X-T-M-E---Mf
m?|M?X---T-E-MM-MTT|---EX-T-EBM-||-oX---E|X---B-oX---|---X|-oEX---M--?o-|-M--?--T?---?MX----X-X--?--??MTB?-B---|-|-M-M-X-?---M|-?M--------E--?--?T-?XE-B----?|X--o--T-T-T---T--?E--o---o-B--MX-----T-M-X
XXXXXXXXXXXXXXXXXXXXXXXXXXXXXXXXXXXXXXXXXXXXXXXXXXXXXXXXXXXXXXXXXXXXXXXXXXXXXXXXXXXXXXXXXXXXXXXXXXXXXXXXXXXXXXXXXXXXXXXXXXXXXXXXXXXXXXXXXXXXXXXXXXXXXXXXXXXXXXXXXXXXXXXXXXXXXXXXXXXXXXXXXXXXXXXXXXXXXXXX
