-o--oB-----------B-M---M-------------------E--E------------o--M-----?-?o---?--oE-----o?-------------------M------M--------E---B-B------B---?-------o--B------E----E--o--B--------BB---M----------B-o----
---M-------B-------M-o----------?----------E--------------------MB--E----B----------?o-M---------?-----B----oB--E----------------M---ME----M---?----o--Eo-------M--------------------E--E---------o---?-
------B----EM-------B-EE----B---------B-------o--M----?-o-------E?E----?-----B-------M---M-----o---------?EEo------B------B----B-----?M--M--oM-----?-------------Eo---------?B--------------------------
-oE---E-----------------o--------------------M-------------?-E--------------o-----------B-o-----------------M---o-----B---------o---?----o---?--M----------B--B---Eo----o--EE-B-o-----E-M--------B--ME--
---B----------E--?oE?------------E--MM-----E?-------M-E--o-?----BE-----------B----M-------------?--EB--------B---Eo-E--------oB-----E-M?----E-------------B------BM-----?-?--B-------?--M--o-------E----
----B-?Bo-----o-BE---B------------B?-B--------oB--M-?------------------?--------B-E--E-E-------B-M------------?B-o----B----B-------------------?-----------E--------E-------BE---o---?B------?---BM-----
------?----------------BM--------?--M---?---Boo-?--?--o?---------------MMM----------?-----E-o--?-o--B--o---E--M--B-------o----B-?-------o----M-M-----BM------E-?---ME----E--------------E-----------o---
-M------o-E---M---M--B--M------BM-------o---o----?-M---E---o---------o------------?--E---------B--o------------E--o-?----o----E------B----BE-o----o-?--E---B---M----E---o---E----B--------?------------v
-M------B-------------oo----E--B-------B------M--M--E---------------M--B-o-------------B-B---M--?---E---B------------------?---------------?-------E----B---------M-o-M--o------B--?-M-M---BE-?--------f
-oo-?--------B----o-------B-------E--------M----------------o?--E--BB--MBE-----?-------M--------EB----------E---?----M--B-------o----------------------M-----o-------------B------E--?---------ME------f
-B-M?o---B-------E----------oo--E---M----------?---B---B---------------M-----oME-?------BB----M----M?E---M--------------B-----M---------------E----E--Eo--------------------o-M------M----o---------?--f
----o--BEB-B--B-E-E--?-o-----M--------?-----E--------MB----------o?----------------B------?E-o-o---?---------B--------?-M--------B---------??-E--------oo------------------?----?--------------------?-f
-B----Mo------E-B--------E--oB----------o-------M--M--B-E----o-?-----------o-----------E-?--M?-----------------?o---Bo-----------------E-B-----?--o------E-------M-------o----------E----?-MM-o?E-----Mf
--------?------------B---E--M-?------------M--B--B-------?---?--?-oB-------E--?o-----oB----------?------o-o--------MB-?---?---?o?-?-------E--o----?---oE-B-------B-------oM-B-----BM--o-----------?----f
m----------o-----o-E|-----o------X--o-|----------o--------------------------------?-|---E---------------oE-?---|-----E------M-----?-----------E----------|---o-?---------X---B---------------B---E-----X
XXXXXXXXXXXXXXXXXXXXXXXXXXXXXXXXXXXXXXXXXXXXXXXXXXXXXXXXXXXXXXXXXXXXXXXXXXXXXXXXXXXXXXXXXXXXXXXXXXXXXXXXXXXXXXXXXXXXXXXXXXXXXXXXXXXXXXXXXXXXXXXXXXXXXXXXXXXXXXXXXXXXXXXXXXXXXXXXXXXXXXXXXXXXXXXXXXXXXXXX
