--------------o------------M?-Eo------------?-------?o-------------M--o-----------------------Eo--------o----B-------------------?--M--E--E---?------o--E-----------E-o------o---?ME----oMM-o-----------
---E-------BE----B--E-------M?-----------M-?--o-E-E-?-----B?---E----B-------E----------o---B-------M-E-B-----------o-----------------?-----E-B-----?-?---M?o---------------o------o-E--o--?M--B----B--M-
-----------M-EEM---?--------E------M-----------?----M--o----ME------B-------------B------M--o---M-------------------------M--o--M------------------o--o-----B--B--E----E--?ME---o----B----M-------------
-?E--B-B-------B-M--------B----B-E-------o-----------------------E--Bo--?E---------Eo----------------B---o-B-------------M---E-M---?o-M-oo-o---?---------?-----E---E-----------B----o----------M---E----
-------------o-oB------------o-M--o-----?-?-------B--M?-----M--o---Eo-----E--------B------?-B-------oo---M---?--------?B-----MM-------o---BB--?M--?--------?----o----------E--?----------?B----------Mo-
--B----------------?--------------M-?--E-------?---------------B-------o---E------------------------o----?-----o-o------?-----------------------M----?B-------EM---------E----------------E?----o---?---
---o-----------------------o-----E---o--B-----?----o----?B-EB--o-o---------?-----M----?-EE----E-M---B---B--B-----M---------B-o-B-----B---B----------------------B-----?-------B-B---------E-----------M-
-----B----------E------E-EE-?o----?-M--------?B---------MM-----E--E---------M------M------M------?------------------?---B-------M--o-----------B-------M-----------B-------------------?---------------v
-?-----------??-----B-----o-------M------E---M----E-----------------B----------o----o---------EoE---M--?----------------o----E-----E-M-M---M----M-------------------o-----------?-----BM---o--------o--f
---B----------B--?-------B----------------E?------o-----M---M------------?--M?-------?----------E-----E-------o--------o--------?-----------B--------------B-EMoE---M-----o--?-----?---------ME--------f
-----Mo--E---------B----o-o----B----B------o-?-??---B-------?-------------B-M----------EB-E-B----M------------------------------------B---------------E-o-?-------------?---------oB----E--oE--o-------f
---B-o--E------B--B---MB---M-----B----oo--E-------------??-M------oB-M-----?------------------Bo-------o--------E------------------------M-BE--?----o----------o--o-E--?E--B---B?------M-EM-o----------f
-----B--------Mo---E-----------B----------E-----------o----BE-------M----E--B-E-----?--------o------B-----M------E---?-E-------------------M----oB--?---o---o-------B-------M--------------E--B-------?f
------------MM----EE-----B------E----------BE?--EB-?--------M---MM--E--M-----M-M--M-----B?---B-----Eo-?------?---oM--------B-M---------?o---?------o--M-------B--o-B-ooM----E-B-?--?-M----E--?--M-B----f
mE--?------E-|-------M--B-----B-?--|----M---B?--------------M------BB-----E-o-|-----oB---------o------|-------E----?---|----o---------o--|X----E-------XX-----oM---?----?M---------|-----M----B-----E-XX
XXXXXXXXXXXXXXXXXXXXXXXXXXXXXXXXXXXXXXXXXXXXXXXXXXXXXXXXXXXXXXXXXXXXXXXXXXXXXXXXXXXXXXXXXXXXXXXXXXXXXXXXXXXXXXXXXXXXXXXXXXXXXXXXXXXXXXXXXXXXXXXXXXXXXXXXXXXXXXXXXXXXXXXXXXXXXXXXXXXXXXXXXXXXXXXXXXXXXXXX
