--------?------------------------o---------o--?--------------------------------------------------------E-------------------------------------o----o--E-----------------?--------------------------------
---o----------------------------------?------------------------------------------o-o-----------o-----------------------------------------------------------------------------------o------E-------------
----------E-----------------------?--------------------------------------?------?-------------------------------------------------------------------------E--------------------------o------------o-----
----------E-------o--o--------------------o-----------------------------?---?o--------------------------------------------------------------------------------------------------------------------------
-------------------------------------------------------------------------------------?----?------------?-------------------oo--------------------?-------------o----------------------------------------
---------------------?-----------------------------------------?-----o------------------------------------------------?E----------E----------------------------o-----------------------?----------------
--------------------------------------------------------------------------------------------------------------------------?-----------------------------------------------------------------------E-----
-----------------?----------------------------------E------------------------------------------------------E---------o--------------------E------------------------?-------------------------------?---v
--------------------?---------------------?------------------------------?---?--------------------?--------------------o------E----------------?------------?------------------------------------------f
--------E----------------------------?---------E-------------------------------------------------------------------o------?-------------------------------?--------------------------------------------f
---------------------------------------------------------------------------------------------------?------------------------------------------------------------------------------o---?----------------f
---------------------?----------------------------o------------------------?--------------------------------------------------?E--------?-------------------------------------------o-----------?-o----f
----------------------------------------------------------------------------------------------------------------?-----?--------------------------------------------o------------------E-----------?----f
---------------?------------------------------------------------------------------------------------------------E--------------------------------------?-------------------E---------------o-----------f
m--------------X-----?------------------------------XX--------------X---------------------X---------X--X-------------------------------X-----X----------------------X-------------------------X--------X
XXXXXXXXXXXXXXXXXXXXXXXXXXXXXXXXXXXXXXXXXXXXXXXXXXXXXXXXXXXXXXXXXXXXXXXXXXXXXXXXXXXXXXXXXXXXXXXXXXXXXXXXXXXXXXXXXXXXXXXXXXXXXXXXXXXXXXXXXXXXXXXXXXXXXXXXXXXXXXXXXXXXXXXXXXXXXXXXXXXXXXXXXXXXXXXXXXXXXXXX
