---------EoT-MB--XE-|XM--T--M-B--?--?-XT--o---EE---|---MX-oEE-----B-?--TT-----oM---T|----M---E----M|BMM--------|X-M-?----BM---X-TE---T-o----X-Xo--?--X-?EETME-oXo-------E--?-|-----T--M-X|---B-X--XM|MM-
--E|TX---o---BE--T---|---T---?-o--?-B-o-E-----o-----MX--|---|-?Mo---E-Mo?B---T-Bo|-?--BE?|Xo-BT-B-B---MT----TTB--M-X--|-----oMX|---o----|-----MXT--oX--BB----ooT-M-B---|-----|------T----BXT---TEE-o--T-
-EMoX----M|-MoTTMXM--T---|---?-?-|M|-To----?-E---T---E---|--|T--|-M|--|----B----MTB-|--E-E?-----?|--o?BE-X|-T-M---E--B----B?X-E--MX-oT-M-oM--X---B-ME?E---BEB-EM--M----EX-M-------X--B--?|--------X-E-|-
-|---EX-T-------?|-|--TM|--B-X?---|T--M-X-T-Xo-----X--------?-?--X|-|-----oXX---|-T-X|-o-X||----?|o-M--BMMM---E---E-EMB-X-M?-o--T?--Eo--XE-?---X-o?--o--?---M|-M--B|X--X|X-E-o-TX---EMXBB-------|--X-MM-
--XXB------T-?-o--?-XTTM-----T-M||----TX??-T--X---TM-|-B----B--?-----X---M-|E-To--Xo----B---?o-|-?T----M-o-B---o|-X----T---XMo-|--?TX---EE--o-T--|-ME---------o-o----|M----|--M-M|B-o|XE---B-EBT-BM||T|-
-|?T--|-|--BXB-o------X-------X-M--???---E-?-------X|E--EX-T--|----M----o-|E--------?EM-----|E----E----M-?EXM?o---?BT-Bo--M-B?-|----EE-B-X-|--X--ToT-B|-E?----??B-E-XTB-------E--?E----|-ooX---?-|-|----
-E-M--?---T-M-o---ME--B|-oE-?T--M-BTB----E----M|XM-B?B---MMMBX-B-B--BE--M---------ooB----?ooEoX----M--XEE|M-----------oB--X-----T--E--?X----o--EE---T-B------MTo--oT--To--T-|E-M--M--o-M--o---|-?|---?E-
-|-T-M--B-----?--o|-E----?|-?-B--?-M----XXMM----E--?--X--M-X-X--TTE---|--M---||-o--|--BX-X---o?-M-TBTE------M|---X?-|-M--Xo-X-o----M-To--M--E?Bo|-M--EB--BMX----X--X-T--E|--|?--B--o-B----MM---B-oT-E-ov
--TE---X------M-XB-E--E-ooBBE----M-------|B---X??--B-||X-B-|B-X-MT--T--o-oB----X--B|-----o-M----?--BX-E-M-M-XEX--?--?-?---X---Xo?---M--X|--E--EX--X-M-E--X----BEooB---X|oXoE-M-BEo-MM---EM-X-?E?B-||-|Mf
---BM----oE-o--MT--o-?-T---oM-?MB-T-|--Mo---B-|---T-oT?-M-TE|--T--B------M---MMB-M-E--BMB-?---?--?-----B----o---oT---M?--BT---?-MB--B-M?-----?---B--M---T----TTT-o---E-X----TB----B---------?X-B-o?-|T-f
-----o---X-o--B|M---o--??T-?MX|-E--E|---TX--M-----BBT----E---E-|-----|o-X---o--E---TXMX?-ETX--E-M------T--X--T-X------M-XE|---X-E--B?--o-o-----ET--|-|?-X-E--T--E?E-XXM-B-----o-------|-B|---To-?-----Tf
---X---|-o--?-??-T--X--B-----E|---|X-XB-o-oB|--E|o-M--?--X---MT---o--T--oB--MB-----M-X?-?-?---M-MT----X-T--------M|B----o--XEX?----Mo----?XM---?-|---M--X|---XT-XE-B-M??--B-|-|------?MB-|--?-?EX-T-B--f
--|B-----E|-|-o-|TB?-EM|ETM|--|--T----|BoEB--XMo-BT---EoM-MM|--M-o------Mo-----??---T---|E?M----EMT---M|----|o-----ET|---EoBTM--BoEB-----?B-oE---BMoETo---o--E-----?-|---|------T-T|-EX--B||M-XXEM-E-X-f
-?--B--?-?X-o--M---?X--?-?--M--o?-o------TT--T--E------M--|B---X|-o-MTM--EE--o---X--M---B-TB----X--o-BT----|E--XXX-o---MT-T--X-|-M-|-X-M-T-MT---E-----T--?-M---X--------ME-|?M-B-o----T----EoXX--XTM---f
m-E-----X-----oX--EEMoB--BE?|To?-|T----M---T-|-?EE|--X|M--B-XoM--B-XXE----Mo-EBo?---|---M-BM|XT--X?o----?--MX|?------|E---oT-o----------M-M-B---?----MoM--E-TE--MMB-|Xo?----XM-T-o--M-o--B---XBB------?X
XXXXXXXXXXXXXXXXXXXXXXXXXXXXXXXXXXXXXXXXXXXXXXXXXXXXXXXXXXXXXXXXXXXXXXXXXXXXXXXXXXXXXXXXXXXXXXXXXXXXXXXXXXXXXXXXXXXXXXXXXXXXXXXXXXXXXXXXXXXXXXXXXXXXXXXXXXXXXXXXXXXXXXXXXXXXXXXXXXXXXXXXXXXXXXXXXXXXXXXX
