--------------------------------------------------------------------------------------------------------------------------------------------------------------------------------------------------------
--------------------------------------------------------------------------------------------------------------------------------------------------------------------------------------------------------
--------------------------------------------------------------------------------------------------------------------------------------------------------------------------------------------------------
--------------------------------------------------------------------------------------------------------------------------------------------------------------------------------------------------------
--------------------------------------------------------------------------------------------------------------------------------------------------------------------------------------------------------
--------------------------------------------------------------------------------------------------------------------------------------------------------------------------------------------------------
--------------------------------------------------------------------------------------------------------------------------------------------------------------------------------------------------------
-------------------------------------------------------------------------------------------------------------------------------------------------------------------------------------------------------v
--------------------------------------------------------------------------------------------------------------------------------------------------------------------------------------------------------
-----B---M------ooE-EE----------------------EXE----M-----?-M----?--------oMo---M-B--E------o-oT--o-BBE---?BM-----o-o-?-------M-o-o-------X?--E----X--o--------BM----E--B----------o------oB?------------
----B--EB----------B-?B---B-E---M----M----ME-X-o--?------MM-MBo-E---o-?-o---------------------|o----M-?Eo--------Bo-M-------?-----E-----XX-------XM-o-??BMo-E---?--B---E-----EM-?-o------E-?-E----------
-?--?-----M--?-----B-----M---BT------------E--X-XE----?--M-XX--o-M----?-B-M-----------?-------|----B---EE-B------oo----E------o------?-M-X-?---BX-----E---T-----oE-o-------Eo-E---o-EM--?M--B-----------
---EM-BT---E----B--M-M---MTM--|-MX--M----------XM-X?TTM-----XB?---M-X--T----o-o-E?----M--o----|--------EoE-?-Bo--ME----o---?-----o-------MX?TB--BXX-T-----|-o--oM-E-T---o-----?MBo--o?-----o------------
--o--T-|T-T--TE-?T--EEo--T|-T-|M--X----------E-TXX--||TT---MMX-o?o--X--|------T------TT-XTE-Bo|-?ET----?-X-ET-M----B----M--o?-E-Moo-----T--X|---E-X-|T-T--|?-ETT---E|-M---XXBToEXXXX-M-T-T-TET----------
m-X--|-||-|--|---|-----XX||-|-|-B--XX----X-----|-X--||||-----XX----BX--|----BX|------||-X|---X|---|-X-----X-|-----B-XXX------X-B--------|--X|--X-X--||-|--|-BB||B--B|--XXX--X|---X--X-X|-|B|-|----------
XXXXXXXXXXXXXXXXXXXXXXXXXXXXXXXXXXXXXXXXXXXXXXXXXXXXXXXXXXXXXXXXXXXXXXXXXXXXXXXXXXXXXXXXXXXXXXXXXXXXXXXXXXXXXXXXXXXXXXXXXXXXXXXXXXXXXXXXXXXXXXXXXXXXXXXXXXXXXXXXXXXXXXXXXXXXXXXXXXXXXXXXXXXXXXXXXXXXXXXX
