--------------------------------------------------------------------------------------------------------------------------------------------------------------------------------------------------------
--------------------------------------------------------------------------------------------------------------------------------------------------------------------------------------------------------
--------------------------------------------------------------------------------------------------------------------------------------------------------------------------------------------------------
--------------------------------------------------------------------------------------------------------------------------------------------------------------------------------------------------------
--------------------------------------------------------------------------------------------------------------------------------------------------------------------------------------------------------
--------------------------------------------------------------------------------------------------------------------------------------------------------------------------------------------------------
--------------------------------------------------------------------------------------------------------------------------------------------------------------------------------------------------------
-------------------------------------------------------------------------------------------------------------------------------------------------------------------------------------------------------v
--------------------------------------------------------------------------------------------------------------------------------------------------------------------------------------------------------
-o---XE----E-o--M--M------------M-?----B-?--?---B-------------?--?-----o-B---------E---?-B--o-E----------M?---B-----o----B--------M------?-?B--o--o--E----B--BB--M-M---o---oo--?---M-oB----B------------
--oXX----------?-o---oX----B--?EE----MMo--o--X---o------B------E---------------E-----------------EB--?--o--E---?---B-------B-B---M-M----M--Bo-B--B---o-E--E--E---?-?E--M--E----------B---B-oE-----------
-BXX---?--------X-?E--X-M---o-----TEE-----XMX-Boo---M--oo--o----??-BE-------?-M-----M---o-----oB----B--o---B-----oo-B----B---------------M-----?-----M----------?----XXB--?B-M-B--?--XEE---E------------
---X---o--?Bo--X---o---X?-M--E-M--|-o-----XMX------?---M-----------?M----MEoM--B-----o-B---MMX-X---E---BT-------M-------------X-X---?---?----TEXo-----?-E--------M----X-M---T---?-TE-X-T-?--------------
---EXT--------X--oE-T-T-XX-XX?B-To|--TT---?XET---B--oBTo-B--T--T--T----B?-X----EB-?-TM-E-ME---XX----T-E?|To--------B-----T-T---XT----X--MT-TE|--XX-X---MT--X--X-TEo-X--X-TX-|---X-|--X?|--E-X-----------
m-XX-|B---X--X----XX|-|-X--X----|-|--||----X-|------XX|-----|--|--|----XXX-X-XB-X--X|-X---X----X-XX-|---||-----XXX--X-XX-|-|--X-|---X----|-|-|-XX-XX----|--BXBXX|---XXX-B|-X|-X-XX|--X-|-X-X------------
XXXXXXXXXXXXXXXXXXXXXXXXXXXXXXXXXXXXXXXXXXXXXXXXXXXXXXXXXXXXXXXXXXXXXXXXXXXXXXXXXXXXXXXXXXXXXXXXXXXXXXXXXXXXXXXXXXXXXXXXXXXXXXXXXXXXXXXXXXXXXXXXXXXXXXXXXXXXXXXXXXXXXXXXXXXXXXXXXXXXXXXXXXXXXXXXXXXXXXXX
