------------------E-----------------E-----------------------------------------------o----------------------E------------------------------------------------------------------E--------------------?----
----------?-----------------------------------------------------------------------------E--------------------------------------------?---?--------------------------------------?---------?-------------
----------------------o--------------------------------------------?---------------------?-------E----------------------------------------------------------------?-?-----------------------------------
-?--o-------?----------------E-----------?-----------?-------------------------E---------------------------o-----------------?--------------------------------------------------------------------------
----------o--------------------------E--------E--------------------------------------------------------------------------------------------------?--------------------------------?---------------------
--?----------------------------------------------------------?---?--------------?-----------------------------?-----------------------------------------------------------------------------------------
----------------------------------E------------------------------------------------?--------------------------------------------------------------E-----------------------------------------------------
---------o--------------------------------------o------?------------------------------------?---------------?--?--------o--------------------------------?---------------o-----------------------------v
-----?---------------------------------------------------------------?----------E------?------------------------??-----o-------------------------------------------------------------------------------f
------------------------------------E-----------?E-----?-------------------------------------------------------------------------------?-----------E---------------------------?-----------------------f
--------------------------------E----------------------------------Eo------------------------------------------------------?----------------------o-----------------------------------o----------------f
----------------------------?-----------------?-----------------o---------------?---------?------------------------------------------------------------------------------------------------------------f
----------?---------------------o---------?-----------------------------------------------------o----?-------E-------?----?o-----o--------------------------------------------o---?--------------------f
----------------------------------------------E----------E?--------------------------------o-------------?---------------E-------------------------o---------------?---?----?-------------------------?f
m----------X----------?X-----X---------------X--------E--------------X-------X-X----------------------EX--------X----------X-------X-----------------------?--------X-----------X----------------------X
XXXXXXXXXXXXXXXXXXXXXXXXXXXXXXXXXXXXXXXXXXXXXXXXXXXXXXXXXXXXXXXXXXXXXXXXXXXXXXXXXXXXXXXXXXXXXXXXXXXXXXXXXXXXXXXXXXXXXXXXXXXXXXXXXXXXXXXXXXXXXXXXXXXXXXXXXXXXXXXXXXXXXXXXXXXXXXXXXXXXXXXXXXXXXXXXXXXXXXXX
