--------------------------------------------------------------------------------------------------------------------------------------------------------------------------------------------------------
--------------------------------------------------------------------------------------------------------------------------------------------------------------------------------------------------------
--------------------------------------------------------------------------------------------------------------------------------------------------------------------------------------------------------
--------------------------------------------------------------------------------------------------------------------------------------------------------------------------------------------------------
--------------------------------------------------------------------------------------------------------------------------------------------------------------------------------------------------------
--------------------------------------------------------------------------------------------------------------------------------------------------------------------------------------------------------
--------------------------------------------------------------------------------------------------------------------------------------------------------------------------------------------------------
-------------------------------------------------------------------------------------------------------------------------------------------------------------------------------------------------------v
--------------------------------------------------------------------------------------------------------------------------------------------------------------------------------------------------------
-?----------?---M----------M------B---E----------M-?Bo-o-----o--?-------------o------E----?-o-B--?M------o---B--?-------E?E?--------M--|--E------M?----?-------M----------B-----E---E------?---------M--
-?E----E------------------E-M------?-T-----o-??-?--TE---------------?--------o---B-?---------M----E---------T--o----------M---?--B-----|--------------------o-B---------T-------------?--B-----Bo?--M---
------M-------?--o-B-----BM----------|---T-------M-|?-oB--B--T-M-?--------BB--M-T---M--o-M---M?------ME---T-|-B-o-M-E-E---M------------|o-----E-------?---?----?--------|--o--M----T----E-E-o-----------
-B-------T-----TT-B---o----------?-T-|---|------T-M|T--oT-ETB|--B---T-?---ET----|?Eo------oM---oo-----MT--|-|--?T--?----T---?----oT-T?-|-??-E-B--MB--?TB-M--T----X----E-|--B-------|-MEM-MT-T------M-E--
-B-TB-E--|T-T--||-?-T--T---TT?-TTTE|-|-T-|T-TMT-|--||MTM|TE|T|-X---B|T-?-T-|E?T-|-TBT--To--T-TT-TM-T---|-M|-|o--|-T-TT-T|-T--T-?--|M|T-|TTT-T----X-T-T|-o-T?|-T-XX--BT--|-TTX-TBT--|-o--TT|-|---oE-TT---
m--|-----||-|--||---|--|---||--|||-|-|-|-||-|-|-|--||-|-||-|||--XX-X||---|-|--|-|-|-|--|---|-||-|--|---|--|-|---|-|-||-||-|--|----|-||-||||-|----X-|-||-XX|-|-|--X---|--|-||-X|-|--|----|||-|------||---
XXXXXXXXXXXXXXXXXXXXXXXXXXXXXXXXXXXXXXXXXXXXXXXXXXXXXXXXXXXXXXXXXXXXXXXXXXXXXXXXXXXXXXXXXXXXXXXXXXXXXXXXXXXXXXXXXXXXXXXXXXXXXXXXXXXXXXXXXXXXXXXXXXXXXXXXXXXXXXXXXXXXXXXXXXXXXXXXXXXXXXXXXXXXXXXXXXXXXXXX
