--------------------------------------------------------------------------------------------------------------------------------------------------------------------------------------------------------
---------o-------------B------------------MM--?--?----------------------B---------------------------?---------------------------------------------E------B-------o-------------------------B------------
------------E-----------------------------------------------B----------B-----------------?-------------------------------------E----------B------------------------B----?-------------------------------
----------------------------------M-----?-?-------------------------------?---M-B----------------------------------------------B----------------------------------------------------------E-------------
-----------B--------------B-----o-------------------------------------o--------?---------B--------------------B-------------------------------------------E----B---------B---Eo-------------------------
----------------------------------------------------------------------------------------M---------B------------------?------------------------------------------------------------------------EB--------
-----B--------------------B---------------?----E----------------B-----?B-----------------------------------?---E-----B--E-----B------------------?---------?---o-----M----------------------M------M----
-----------------------------------o-------------------------------------o--------------------------------------------------B---------------------X-X--------------------------------------------------v
-----------------------------------------o---------------------------------------------------------------------------------------------------------X----------------------------------------------E-----
--BB------B------E-----M-B--------?-----?----MEXE----M-----------?oM--M--M--EB-----B--E---MB-B---------X-XBX?o-B---E--B---M--?--o-M-----E--B----EME-Xo--------M?------M--E---o--E-o---M--E----XB--B-----
----E-?--B-------M-M--?---B-M-?---B---------?---X----EB----?-----B----o---B--?-?-oB--------?----B?--MoE-X-X----M--?-----B-----B---o----EX-?---X----X?-o-?M---------------E-oo--EBB-B--?-o--M-Mo---???---
---E--o-------B--B---M?E-----Eo----BMB----M----X---------B----EM---------o-o---EM----?B-M-------X--B?----?-MEXo----o--?---M---?----------X----X?--XX-ME-------o-----B--o----X-M-?--------X-X---X--XM-o--
-M-o-B--o---?o---------B-?--?------M-------E--X---oBE--o-----M--EB-----?----o--EM-B--o----?M-X?X-------E-MXXX-X-------M-o--------M--------X-B-M-XoXX---X?-E---------------o-EX------oMo--XX----X-X------
-o--o-----MME--o?---E-?---?--XE--o-E----------X--------X--M--X--o----BM-B--B?-X?B--oE---MM--M-X--BB----Eo-X-X-X--?-??--B--------?-o---E--XX--oXMXMXB--X-X-oo------?-----MX--X-----?---M-B-X--BXXX-------
m-X-X--X--o|EBX-?---o-Mo--X-?X-X--X---?oE-o--B-X--X--M|BM|?-X---X-----X-oXM-XX--MB--X|XX|X-X---X-X---?-----X?--X-X||?--M--M---XX-o--X----XX---M?MXX--BMXo--M-o?-------M--XEM-X-??----M-?-M-X-XBX?M--E?--
XXXXXXXXXXXXXXXXXXXXXXXXXXXXXXXXXXXXXXXXXXXXXXXXXXXXXXXXXXXXXXXXXXXXXXXXXXXXXXXXXXXXXXXXXXXXXXXXXXXXXXXXXXXXXXXXXXXXXXXXXXXXXXXXXXXXXXXXXXXXXXXXXXXXXXXXXXXXXXXXXXXXXXXXXXXXXXXXXXXXXXXXXXXXXXXXXXXXXXXX
