--------------------------------------------------------------------------------------------------------------------------------------------------------------------------------------------------------
------------------------?------?----M--------------------------------------------B-----------B----o-----------------------------------B-------------------------------------o--------?------------------
---------------------------------------------------------E-----------------------------M--------------------------------------------M---------------------o--------E------o-----------------------------
-------------------------------------------------?---------E-----------------------E----------------------Mo-B-----------------------------o--------?-----------E---------------------------------------
-----------------------------------------B-?------------------o-------------?-----o-------?------------------B----o----------------------------------------?-------------------B------------------------
-----------B---M---------------o-------------------------------?----------------------------------------------------MB--------M------------B----------o--B--M--------------o--------------E-------------
---------------?----------------?-------M--------M-----------?-------------------------------------------o------------------------------------------------------B---------------o-----------------oB----
---------------------------------------------B--------------------M--------------------------------------------------------------------B---------------E----M---------B---------------B---------B------v
------------B---------------?------------------------M-----------------------------------o-------------o-------------------?-----------B--------------------------?-o------------------------?----------
--?----M----o-------?-----B------B-oB----B--MB----?--EE-oE-------o-?o------?-E------o---B------M--E----?-E-M-o--E-----E---MB--o-B---E-EoB?-----MB--?------o-----------B-?---B------------?-M-?EE----o---
-----o-M---B----------B--?-?----BBE--MM----------oB--------EB--?-Eoo?-----E-----------EBo-M-B------o---M--?E-----o--?--E---E-o----------M--B?------?--E--------B?----E----EB---?---o-----E?--o?-B----o--
-------------M-o--oo--o---?-----M-?-B-------?-EM??-BE-M----E------------------E----EE-?-M-BE--B--?--?-BE------MB----?o---M--------------M---------MM--BB-------X------------?---M-M---?--M-----o?B------
--?----??------------E-?----M--EB----?-EE-------?------?-o-XE--MM------B-?-------o---E---o--E-?----------Mo-------?EM-EE----M---MB-B-E-B--M-------E--E-----EB--XE----------M------------M---------------
------?MB----?-B--E-EBMXM---MM----------B--?--o-o-------Eo-X----B-B---------B-------EM-------o--------M-E------------X-?-B-o------Bo---?---E--X----?--Mo-----o--X---o---EB-oM------BM---E-MMEMM--B-??M--
m--X-X-X----B-o-------?X---BoXE--EXBoB--o?---B-XX---X--?-XoX-B---X--?-------------M--BE--------?---o|o---oo----XB--ME-X-----BB-----X-XX-----XE-M?---X-oB-X-B---EX----?M-----------o-XBo---?B------X--?--
XXXXXXXXXXXXXXXXXXXXXXXXXXXXXXXXXXXXXXXXXXXXXXXXXXXXXXXXXXXXXXXXXXXXXXXXXXXXXXXXXXXXXXXXXXXXXXXXXXXXXXXXXXXXXXXXXXXXXXXXXXXXXXXXXXXXXXXXXXXXXXXXXXXXXXXXXXXXXXXXXXXXXXXXXXXXXXXXXXXXXXXXXXXXXXXXXXXXXXXX
