--------------------------------------------------------------------------------------------------------------------------------------------------------------------------------------------------------
--------------------?---------------M------------------B--------------------------------------------------------M---------------------------------------------------------------------------------------
------M------------------M-------------------------------M------E-------------------E---------------M--------------------------------------------------------------------------------------------?------
-------------------E---------E-?------------------------------------------------B-------------------E------------------E--------------B---------------------------------ME---------------o--------------
----------------B-o-------------------------B-----------------------------------?------------------------------M-----------------?------------B---------------------------?----?------------------------
-----------------------------o?-o------------------?------B------?--E-----B----------------------------------------?-------------------------------------------------X----------------B-----------------
----------------------------------------------------o----------B---------------------------X-B---------------------------------B--------------------------?--X--------X---o-----------------------------
--------?---?--------B--------------------------------------------E-----E------------------X----------E------------------------X-------------------------B---X-------X---------------------------------v
---------------M----------------------------------------------------------XXo---------------X--X--------o----------B--------B-X-----------------------------B-X-----X?---XB----------------o------------
--B--?-E--XX-o----EX-?-?X-X--oX-?ooB-X---oXX-X--o--?------o-?E?--E----??XEX-X-XX---B--------?XX------EXo?BE------------?XX-XBX----?---E-X-----XX---?--o-------X------XEEXXXX--o--oo-----E----o-?----E-B-
-?----??-?MX--E---?-X-XXXX-E---XXXX?X--?X?--XE---?-E-------X?o-?-----?XM-X?X---X--?-------E-XX-?-------XXX---o?oEo----?-X---XB-E----o---oX?-XX----X-X---?------X-----X-X??XE--?-o---o-?-------o-?B------
----?-----X?B-------XXXoX--Eo---X-oX--XX--E-Xo-----o---?-?--X--------XXX-?MXX?X----?--o--?Xo-X-?-??---E-XXX--?----E--o--X--?-X---E--------XX--XX---X----?-------XXXXX?X--XX--E---------E------EX--------
----?--X---X---?---oX--X-X----o-----X--XX-?-B--E-B----?X-?E?X---X-Xo--X----XXXEX----?E---X-X--XE-----?---XMXX-----o-E---XX?-?-X--BMM-E---XXXM-X?---?X?o-X---E--EX--X-oX---X----?----E------X-XX-o???-??-
-ooo-----EX-o-?-TXX-XT-EX-X???EXXXX-X-TXo?XXX?-MTEE---T-XX-XXTXTXXTXX-XX--?oX-X---------??XEXXX?XXX--X-o--X--XX----X---ToXX--XX--?--o---X-X--XX-EXX-----XXX--XXX--?--XXXXX-T-------?--EoEEoEX-X--X---X?-
m|o----X-XE--EX-|--XX||?-X-X----X-XX?B|X-XoXXE?X|o--o-|-XX-X-|Xo-X|X--|X|-?o-X--E--|---M-X|XX-X--X--?XXXX-?X?X-E--oX--?|-XXX-X-E---X|---Xo?XX?XXXX-XX----X-?EEX--?--X--XX|?|-------|XE-|?-o-XXBX-XX-EXX-
XXXXXXXXXXXXXXXXXXXXXXXXXXXXXXXXXXXXXXXXXXXXXXXXXXXXXXXXXXXXXXXXXXXXXXXXXXXXXXXXXXXXXXXXXXXXXXXXXXXXXXXXXXXXXXXXXXXXXXXXXXXXXXXXXXXXXXXXXXXXXXXXXXXXXXXXXXXXXXXXXXXXXXXXXXXXXXXXXXXXXXXXXXXXXXXXXXXXXXXX
