--------------------------------------------------------------------------------------------------------------------------------------------------------------------------------------------------------
--------------------------------------------------------------------------M---------------------M-------------M------o-------B----------------------------E-----M-----------------o---------------------
---------------------------------------------?----------------------------------------------E--------------------E---------------------------------------------------------------------E----------------
--?------------------------------------M-----------------------------------------------------B---------------------------o----------------B----------------------------B--------------------------------
-----------------o---------E----E-------------------------B-----?--------------------------------MB-----------------------------------------B------------------------?------E-------B-------------------
----------------------------------?--------------B--------------------------------------------------------------------------M?----------------------------------------------------------?-------o-------
--?------------------o------------------------------E----------------------------------B------E---------------------E--------------------------------------------------E--------------------------------
--------------------------------------------------B---------E--------------------o-----------------?o--------------------------------------------------------------------------------------------------v
----------------o---------------------?------------------o---X-----------------?---------------------------------------B---------?------------B------------?-----------E-------X-----------------?------
--?------------EX?-oXXX------------??--------B-EoX---XX-----XXX-o--?--XXXX?----?XXX?E--------E--?-E??-----o-E??--E---E--E----?---?-??---E---E-o-----?------M-E-XXX--------?-XXo-X--------??--------?o---
-ME-?--o--E-M--XXX-X?X-E----M--E-?------?-------X-Xo?XX?E--EXXE?--?E---X?X--o----X-XX--oB-----??---o--X-EX---?---o-?E-------M---E-------oo-EEE?---?------o------X--?E--?---X-o?EX??--X------E?----X?--E-
-?---------EXEXXoX-oXo---XE--o-?-XXE?-?-?--Eo----X-XoX-X-----X------T---Xo---?--M-XBX-E----o--?M?XXX-oX--XE--------E-o-EE-----------E--o-?--X-----E?----------X-X----------o-o-X--o-?EX??--oXE-oXX------
-----?-----X---XX--EX-o--X-?-?--X--XXX----XE---X--XXXXXX--o---?-?-E-|---X----?-o-X?X---?----------XXXoX-X-----??-------?----E---o--?o-----X-XE--?-MX---------XEX-?------X---X?XX---EEX-?----?X--X-?oo---
-----X--EXX-----X?o-X-X-XX-XM--oX-XX-X?---X-X--X-XXXX-X-------------|T---X-T------M?-T?---------?--XXX?--XX----E----E---X----?-----T--ooXXo?XXXoXo--XX----?-XEX?oE------XXXXXXX----?XX-XB-X-E?X--XX-----
m-Xo?XX-X-XX----X|-X-?XX-X-oXXXX?X??X---oE?XXo-XXX?XE-X-o---?EE-|--X|--?--o|------Xo?|?X---|--?--X|XX|-XXXXX-E--|-E--X--X-?-X-o-?-o|?-Xo-X??X--X-?-|-XXX-X-XXX--?--XX-X--XXXXX-XooEXX??X-XX---X--X|-----
XXXXXXXXXXXXXXXXXXXXXXXXXXXXXXXXXXXXXXXXXXXXXXXXXXXXXXXXXXXXXXXXXXXXXXXXXXXXXXXXXXXXXXXXXXXXXXXXXXXXXXXXXXXXXXXXXXXXXXXXXXXXXXXXXXXXXXXXXXXXXXXXXXXXXXXXXXXXXXXXXXXXXXXXXXXXXXXXXXXXXXXXXXXXXXXXXXXXXXXX
