--------------------------------------------------------------------------------------------------------------------------------------------------------------------------------------------------------
------------------------------------M-------------------?-----------------?----o---------M---------------------------------------------------?--E--o-----------------------------------------B----------
---o-------------------M--------------------------------------------E------------B----o----o--------------B--Bo---?-------------------------------B------------B--M--------------o----------------------
---------?-E---------o--------------?-----------------E------E----------------------------M----M-------------?----------------------M------------BM-----------------------BM---------------?------------
---E--?-------------------------?---------------------------B--------------------------------------------------------M-----------------------?---B----------M----M--------------------------------------
-------M----E------------------------------------B--------------o----------E--------------------B---?------B----E----?----------o-----?---E------------------o-------------?---------E------------------
--------------?-------------------B----o-----E----------E----------B-----B-----B------E--------------E-------------------------?------------M----B-------o-E------?-----------------B-------------------
--M--------M----------------M----o-----------------------------------------------------o----------o------X---------M---E-----------------E-------------------------------------------------------------v
--M--B------o----o-B---------B--------o----------B------------M-E----------B----?------------B--------o---X---B------------------------------------------X---------------------------------------------f
--M-oB--------------B------B-o---o----------BE-o--o-------E------B---o---MBM-----M---EE---B------?-----MBXXo?--E-?-----B-----o----M-------o------?--------X------E--------?-??-------?-B-X-------------f
---E---M---M-----------B-M-------B-o?-----Mo-------------M-------B-?-----?----?------------?-EE--B--M-B-oX?-ooX------o---------?----o-?---------E-E-------EX--E----?-M--ME--EM--M------X---------------f
---M?-X------B----?M---------------??B-------o---M---?---o----E-oE---E----M--B--o?X-|---?----oMo-?---o-B-EXX-XX-------o-EB-----?o------MB-M-EE---?---T-?BEXXX--E?----B-o-----B---------X-oM------------f
-E-XXEXX-----T--------B--?o----------T---X--X---ET--oE--T--X-X---o--T-T---??----?X--|-o----X---M--XX--o---XX-XMTM-E------o------oE------M?---o-?M-BM-TM--X--M-------T-MMo--E-?----------X--B-----------f
----X---BoT-B|---T?B-BT---oooE--EX|?-|-TTMXX--XMo|T-T--TTM--XXT--|-o|E|?T---T?-E----|T-o|--?X--MT--X---TT-X-XT-|?--T-----|T-----To---E-Bo-T---T-EB-?-|-XXMXo-----o-M|--ToM-B-TT?-TT-E-M--X-E-?---------f
m---XX-X--|-X||--|----|-----|-B-XM|--|-||B-X--X-X||-|-X||B-X-X|--|--|-|-|---|------M||--|------B|--XXXX|--X--|-|--X|----|||-----|-------XXX--B|------|--XXXXX-B--------|--|----XX||--B--B----|---------X
XXXXXXXXXXXXXXXXXXXXXXXXXXXXXXXXXXXXXXXXXXXXXXXXXXXXXXXXXXXXXXXXXXXXXXXXXXXXXXXXXXXXXXXXXXXXXXXXXXXXXXXXXXXXXXXXXXXXXXXXXXXXXXXXXXXXXXXXXXXXXXXXXXXXXXXXXXXXXXXXXXXXXXXXXXXXXXXXXXXXXXXXXXXXXXXXXXXXXXXX
