-------------------------------------------------------------------E-----------------------?--------------------?---------------------------------------------------------------------E--------?--------
--------------------------------------------------------------------------?-------?-------------------------------------------------------E-o--------------------------------E--------------------------
-----------------------E-------------------------E--o------------------------------E-------------------------------------------------------------------E--------E-----------------?-----------o---------
--------------E-------------------------------?---------------o-------------------E----------------?--------?-------------------------------------------------------------------------?-----------------
------------------------------------E-----------------------------------?----------------------------------------------------------------------------------------------------------------------------o--
----------------o----------------------------------o---------------------------------------------------------------------------------------------------------------------?--?---E-----------------------
-?---------?---------------------------------------?-------------------------??----------------------------------------------------------------------------------------------------------Eo-----o-------
---------E--------------------------------E-----------------------?------------?------------------------?----------------------------------------------------------------------------------------------v
--?----?-------------------E----------------?--o-------------------o-------------------------------o----------E---------------------------?------------------------------------------------------------f
-----------------------------------?------------------------------?----------?----------?------------------------------?---?----------------E------------------------------------?---------------------f
-------?------------------------------------o-----------?------------------------------------------E---?-----------------E----------------------------------------E------------------------------------f
--------------------------------------------?-------------------------?---------------------------------------------------------------------------------?----?-------------?---------------------------f
--------------------?----------------o---?----------?--------------------------E--?--------------------------------------?------------------------------------------------------o--------------?-------f
--------------------------------------?---------------?-----------------?----------------------------?----------?---------?o------------?----?-------------------------E-------------------------------f
m-------X---------?E---o-X------------------EX----------X-------------X---------------------------------------?--------------------X--------------X-------------------------------X-------X-?o------X-EX
XXXXXXXXXXXXXXXXXXXXXXXXXXXXXXXXXXXXXXXXXXXXXXXXXXXXXXXXXXXXXXXXXXXXXXXXXXXXXXXXXXXXXXXXXXXXXXXXXXXXXXXXXXXXXXXXXXXXXXXXXXXXXXXXXXXXXXXXXXXXXXXXXXXXXXXXXXXXXXXXXXXXXXXXXXXXXXXXXXXXXXXXXXXXXXXXXXXXXXXX
