--------------------------------------------------------------------------------------------------------------------------------------------------------------------------------------------------------
----------??--------------B--------------------------M------------------------------------------------------------?-------------------------------?-------------o---------------------------------------
------------B--------------------------------?------------------------------------------M-------------------------------B-------------------E-----------------------------------------------?-----------
-o--------------E-----------------E------------------------------MM--E---------------------------o-------------------------?----------------------------------------B----------?-----------------o------
-------------o-----M-?---------------------------B-----------------B-------------o--o----------E---------------------------------------------o---------E-------------------------------o---o------------
---M-------------------------------------------------------------------------E---------M----------------------M--B------------------------??------------------------B-----------------------------------
-----B--------------------M--------------?----------------------------------?-----------------------------E-------------------------------------E--------------M---------------B------------------------
-------?-------B----------M---------------------------?-------------------------------------------E-----------------------X--------------------------M----X-X------------------------------------------v
----B--X-----B-------X-X--o----------------------X--------------X------------X--------------?--------------Mo------------X--o----------o--?------------B-X---X-----------------------X-----------?------
-------XX-X-XX-?o---o-XXX--o?E--o?E?X-XX-X-X-?--X---EE--XX-X----oXXXXE--------X-X-?-o-?----?----E-XX--EM--oXXXXo------EoX-X---X--?-X-o-?X-oo?------E--X-oXX?E-X--?X-X?--?E---E---?----X-E----o-XXX--?---
-?-----X?-XXX------?E-EXo-?------Mo?XX--X--XXo-X-?-?oo--XXX?X--?XXXXX?---?---XXX-XXX---o----E---X-X?X-X----XEXo?---E-XX--X----X---?-XXXXX-------??E--o-XXX-XX?X-?-X-X?-XE-----EXBE--BXXXX-?--XX-X--o-?--
--?---X?--XM?-oo-----??XX-------ooE-X-oXXX-XXX--X---o-?--XXX?--X--XX--?o-o?---X---X---?-o??-?----XoX?-X-X---X--?--X-X-XXEXoXoX------X-Xo-XX--E-E-oEo-?-XXXX?-XXX--?XXoX?-----X-?X----X-?X----XXX----?---
---Xo-----X-oX-E?----XXX---?----?--?-X-X---oX-XX---E-X-XXXX--?E-X-X-?--?oXXXXX-o-E-XEX-EEoX--M----XE-o-X--XX-?o--XXXXo-EX---XXX-oXBXXEX-oX-XXX-X--?XXXX?XXXXXX-XXX--E-X-E--X---X?E---MXX?---o?XXo-------
-----oEEX---BXXX?--ooBXo-E--o?-----E-XX-XXXXo-oX?----X-XXX??---o-XX-?XX?XX?-X?----X-XX?X-X?-----M??XXoX--oXX---B?X-XXEX-?XXBXXX?-X-XoXX--XX-X?X---M-X-?XX-XXX?XXXXX--X-E---X---XXTo-XXXoEE-----X--?XEX--
mE-X?-X?XXX--X-X?o|B??-XXX-oX?--?X-?-?XXX-X-E--XXXX-X-----X--EoXX-X---X-XX--X-X--X-o-X?XX-----XEE-XX-X--?XX-E---XX-X-X--BX-X-X-XXXoX-XXEEX-?-EX??---EX-oX-XXXXXX-X-X-XX-----X---X|oEXX?XX---E?-X--MX----
XXXXXXXXXXXXXXXXXXXXXXXXXXXXXXXXXXXXXXXXXXXXXXXXXXXXXXXXXXXXXXXXXXXXXXXXXXXXXXXXXXXXXXXXXXXXXXXXXXXXXXXXXXXXXXXXXXXXXXXXXXXXXXXXXXXXXXXXXXXXXXXXXXXXXXXXXXXXXXXXXXXXXXXXXXXXXXXXXXXXXXXXXXXXXXXXXXXXXXXX
