-------M----E-E---B--B--------------B---B--Mo---B-----Eo-E---M--------M---------------o------------B-------------M-----?------M--E--------MBE-?----------------MB-oE----B--o--------------?----E---M?E--
-o------B-----?--o---------o?----B-o-----Bo-------MB--BB?----oB---------M--o------------B??E-?-------BM----B-------o--------B---------E--o--o--B-------------------------B--o--Eo----?-o----oEB-----M---
----?--------------M------------------------M--o---M?--B----EE----E--M--------M-B--M----o-----oB--o------M-------M-------M---o-MEB-------B--B---o-------------?M--?------?----?---?-------o---?----?----
------B----------B--------------E--------M-----?--------------------?----?--------M-------?M--MM------oMEB--E--o-----E-?---EE---o-----?----B-E?--?-M----?--E-------------?-B--Mo---E--B-----E---------E-
---?--M--B-B?--o-------o------B-----o-E--------------------?-B--?-M-o----oM-----------o-M-------------?--------------E---M---E-----E------------------B-------------o?-----M--o------------?-?-E--M-----
-M-?---------?-------------B-E----E---?--?----??---o--ME---E--------B--B-E---E--------?-----o--M------M--E-?--------?---B--?---B-EB-------------B--------M--M------E----?--------B--------E-E--B----oB--
---M--B---------B-E-----?--oo--------E-?--M-B------M??-------?--E--M------------?--?-----?----B?BE----------------?--M-?M-----------?---------------Bo--M-----B-------?--BM-E-E---M--o---?-M------B-----
--M-E---M-----M---------E---?------?o-------B-o---B------M--oB-----o---B---o----------E--?---------E---?-M---------M--------E---E--M---------B-M---M-----------MM--Bo----o--BE---------?-M-------o--B-Ev
-B---?-B-B-o-------E--EM------o-----------------?-------------------E------M-E--?----o---E---B---BE------M---B---?---?M-----??B-Eo?---E-M-------M-----B--M-B--------?-------o-ooB------------?--------Mf
---M-------?----B---------------M-?-MEo------------------E-------------------o--------?---E----?----------?E------B--------?-----E-BBBB--o---o--M---M--?--M-o-B---------------E-M----E?E---?M---EEM---Bf
-?--o-?-------M--EE---------oB----B---M-BE--B?-----oE------B----EE---M----E-------E-?----------E-?---B-----B?-EB---------------?------M---B------EEE--M------?M-o-----M--o-o-o-------ME-o-o------------f
-------M-B--M--------BE-EB---B-----o------M-o------E-------B--------M---E--------EEE-B-----------------o?------M---B-----------E----E-E--?---------M-----?-B--B-?--------BM-M-------Mo-ME---B-----B---Bf
-?----------?---------------------E--?B-----?-----------E-------------?---M------o-----?-o?-o----MM--------M-------B----E-EE--E-------E----------B-BB-E-E--Eo----E----?--oBB---M--o-o---B-------M------f
----?--o----------Bo---------E--------------------E--?--?--o------------B----------B--M---B---oMM?--ME--B----------------?-B----------------E--E----EB---?---?-?-o---MX-------M--M?-MB----B-----B------f
m---M----------------------X--------|--o------o-------E------X----------o--o--M-----------?|-----?-------B-------------Xoo---BB---X-------oo------|--------------?---X-|?------|--B----M----E|BB-------X
XXXXXXXXXXXXXXXXXXXXXXXXXXXXXXXXXXXXXXXXXXXXXXXXXXXXXXXXXXXXXXXXXXXXXXXXXXXXXXXXXXXXXXXXXXXXXXXXXXXXXXXXXXXXXXXXXXXXXXXXXXXXXXXXXXXXXXXXXXXXXXXXXXXXXXXXXXXXXXXXXXXXXXXXXXXXXXXXXXXXXXXXXXXXXXXXXXXXXXXX
