-E-T--M--?X--Mo--|-M----T|-E-Mo-|-B----E----E--X|E-?-?-E----MoB-MT---TE|----TETM-TTB-?|-M--B--T|--Eo--|---EXE--T-----T-M--To-Eo--E-?TE----T|MTB?-TM---o-M-E|--?--||-BM---------o-oo-|---X------?-T---B--
--M--E|--E-Xo|-XBXM---XX-?M|-|-----T--X-M-?-M-XB-EE?T---E--B--o-----XE--MT--o-EM?-M-BX-------E-ETBX--T------E---BB-T----B-Eo--M?o-T-?-EMBM-o-X-B-X-?TE-|---?---M--XBMTM--|-M----oM?--TM----B-Xo--ME-o|--
------oX-M-B-----M-T-o-M?oM-Moo--E-oo-|E--M--|M|---MX--|----|-|B--XTTo--TM--------------X----o-BXo-B--?------MMT------|T--M---B-B---?-oEMo-BM--|oM-o-oM-XEM--|-E-----XB-M-B|-X-|-|o---E------Moo-M-X----
--?---o?-X---Eo|M-|-|--TE---T|--X---T-E-B-E-XM-?-M-o---T----M-B----T-TE---M--MT--ET---------E--T-Mo--Eo-----?E----------|--------o--TMB?T--EM----?B-?X--XE?-B|-B--B-----T?-B------?o?o-E---T|--XE-X---?-
---|-o-o--?------?----TM-T-?-E-M?-E--B?-T--MM-oM-TBMMo---XXo-BTM----XX-----E--X-?XT--?------|-|-TX--M-o--oX-T-|B----MXTEE|--M-----o----?EE-ooXB--M-B---MT----MTEoTTT----EM--o----XEX--X---|-E-oM--E-B-B-
-----B-M?--X---X--E--TB--X-MXMM-----E-??-|-T----BM---o-T-o-??-E---X--T----|--EM-o--E|----E--------?T-X-EMX|---BTXoM-X-----o-M---|-|?-B--?BBM-|BTo-BEoM--oT--o---T--B-M--M|-B-X--|Eo--TT-Mo--------E-Eo--
-|-E?-----o--||-?--|XEME-B-XB-|X--T-XT-E-TT-|---X-E-T?----??-?T-M?o-M-------M---|----?-o--|-X-TB--?---M-|--?MB--E-?----E--E-?-oX|---?E-TE?--|TE----M--M?E-o------|-B-------E-E--------o-T|-------?-B-T|-
--M-Mo-o-----M-----E?----E-o|?o---------B|---M-o-XX|XT-B----|-E-E-Xo-E---BB----?--XEToo-oB-T-E-?o-B|B?||---EX--E|-o-T-oX--E-X--BE------o---T-?E|T---|--?---TMo-----B|E-?-----|---?M---|TTXME-M--M-T-?TMv
---------|o----?--B----?--B----M--|TBX-----X-EM--M---T--?B---X-----?-|-TXE-BME-?--X-----X-BM--XE|-MX-------o--M---o-|E--M-T-?o-o?-T--Eoo-M--M---oT-----TBX-M----E--E|--E--?-|-ET---ET--Eo-E--Eo?--|?--of
--M---TX--B-M--Xo----B----E?MMT?--B-|---MX---o?------o---M--BB-X-To-B---?-TB--?oX-------B-T--TEE-T---|T-X-?o----|T--|T-EEB-BT|-o-o-BBo---------|-?-o--M-o-X--o--B--o----T-XX----B---M------M|--M-X--E|-f
-----M?---XXM--o?----oT?---B-|B---X?----?||--|-T--?--To-X---?-|---X-M-XM--B--?T?|E----XTB-M-?-B?X?X-MX-o-?E----|X---?XoTM-B--E---?--BX-E-|-B--E|B---B-?-?------BX|---TooXB--BM-?TX-------E----Too---TT-f
------E---B---B--M-MX?-------?--oXoX--BX?X-BE-|oB--o--T--|--Mo-M-|-|----M--|BTBM-----BX-T??M--oT--?X---?||-T-M|---o-?T|-Eoo|-oo-|B--M?--T----XBE---T-o--M?--o-EXTM-T-BMo-?-------------o-MM-oMM---o-XB-f
---BE--EX--------E-|---T-T--M------------X-?-B-|-T-T-M--X|B--XoE----T--T-oo-B-TE--|X-E---||?||oX----|--METB-T-----M?TXT----EB|o----|-X-o---E-----EM--MTo----TX-E--||o--B--EE------EB|T-M-----?---o-B-BBf
----X--o---X--BM-XB|M-XX-M--M|E--Eo|M|---o---ETM-|-o--EBT-----o?---M-|-E---TT-|o-oE-?-EB|---B--------|-?BX?-----|ToXX?-MM-----X-?E-B-E?---M-E-TM-|o---T--?o-----Xo-oX?M-?---X?-o-XX-M-E-BE-XM---XM-BMoBf
m---M-?To-M-T--EX---EE-oM?X-|M|-|-----o---B--?T----E---T---?-B----o-B-----T|?|M?--T---M-M--X?--?EXTB----MooE-o-M-M|-------XB-----BT--X-o--M-----?T--|-X---oB----B---?--BoT-?-E-T-X-T--To-----|-M---?---X
XXXXXXXXXXXXXXXXXXXXXXXXXXXXXXXXXXXXXXXXXXXXXXXXXXXXXXXXXXXXXXXXXXXXXXXXXXXXXXXXXXXXXXXXXXXXXXXXXXXXXXXXXXXXXXXXXXXXXXXXXXXXXXXXXXXXXXXXXXXXXXXXXXXXXXXXXXXXXXXXXXXXXXXXXXXXXXXXXXXXXXXXXXXXXXXXXXXXXXXX
