--------------------------------------------------------------------------------------------------------------------------------------------------------------------------------------------------------
--------------------------o---------------------------------------------------------------------------o-----------------------------------------------------------------------------------------M-------
-----------------M--------------------------------------------------?----------------?-------------?------------o-------------------------------M--------------------------------------------------M----
---?-----------------------------------------------------o--------------------------------------------------o------------------B------------------------------M--------M--------------??----------------
--------------------------------------------------------------------------M-------B-----------------------------------------------E---o---B----------------------E-------------?---?--------------------
-o-------------------?-------------------------M--------------B--B----------B------------o-------------------------?-----------M--------------B------------------------------------------------------E--
------------------------------------B--------E---------------B-----------o-------------M------------------------------------B---------------------------------------------------?------?----o-----------
--------------o--------------------------------------o------------M--------------------------------E------------o--------------------------------------E---------------------------?---------------?---v
------------------------o--------B?------------------------?-----------------------------?------------------------------------------------E--E----------------------------------------------------------
--------B?---?---?-o-?--o---?o---E-MoEE-oB------M----oo----Mo--B--M?o-----M--XX--oB-B--M-Eo--Mo?--B-?--?-EE?EXMXE-B-o----B-------o------------?o---------------E?------M-----X-----E-----M----E----?----
-E------M-M--Eoo--o----EM-B----?-B-M---B-?BMM----M-M-?----------E---B---B----X----MB---E---M-B-E-----M--M-EE-XXX---o---X-----M-M---?----E---M----E------------B--XXX-o-o------X---------o----?--?B??----
----Bo---X?XB--o--MX------?-o---?-----XXX-oB--?B-E--BM---?M-?-MB---?X---B----X--M?B-----M-------o-----M---?X-XX--E--E-B-X-?B--E--B-M------oE---E---?--?EM-B---M--MX-----MMB--Xoo----E-------------o-----
--B--E-MXBo----M--X-?M-M?---B----?-----X---o--o----XXoEo?----B-----X-------?-BX?X--?------------?XX-----?-----X--?----XXM--X--E--o?--EooM---B--B-----oE-----X-----XME--E------X-E-------?--B---------E--
-o--oMX--X-o-E---XX-BM-M----MX-M--M----EXX?----o---oX--?---o?B----o-X-X---?---EX-BEMM----o----?---X-o---XX--oX--X---EXMX--E-X--E----------oEMXB-BB--o--------X--X-X------------o-E-------o--------o-o---
m----XX--EXoEo--o-XoM--o--E-oX---XX-----X-----X-oBXXX?-X-BX-M--X--oXXMXE--XX---?X|X-B-XE--------EX|Mo|XB-X|oXM-X-M---XMX-XEE|Mo---o|?X-?---EX?-XX-XXX---X-XoXX|---XM----EoX?-BX-E|o--oB---X-?---?-XMB---
XXXXXXXXXXXXXXXXXXXXXXXXXXXXXXXXXXXXXXXXXXXXXXXXXXXXXXXXXXXXXXXXXXXXXXXXXXXXXXXXXXXXXXXXXXXXXXXXXXXXXXXXXXXXXXXXXXXXXXXXXXXXXXXXXXXXXXXXXXXXXXXXXXXXXXXXXXXXXXXXXXXXXXXXXXXXXXXXXXXXXXXXXXXXXXXXXXXXXXXX
