--------------------------------------------------------------------------------------------------------------------------------------------------------------------------------------------------------
------------------------------------M--------E------------------?--?--------------------?--------------------------------------BM------M----M-----------B-----------------o------E----?---?-------------
---B--------------------------------------?-o-E--?--------------------------M-----?---------------?o-------------------------M-----E-----------o-----E---------------E----------------------------------
-------------------M-----?M-----o-----------M-------------------------?---------------B----------------------------E--M------------------------------?------------------------M-------------------------
---------------------------------------B-----------------B----------M-------B-------------------------------------------M------------MB--?-----------?-----------BB-------B-----------o-----------------
--M-------------------------B------E------------------------------------------------o-B---------------M-------E-----?--o-----?------------------E-----M--?-----------------o---E--B---Mo--o-oE----------
-E----------------M------------?--M-------E--------------------M------------------------------M----?------------?--------B----------M----------B------------B-----------------o-------o-----------------
-----------------------M---------M--------------------o-------B-?---B-B---------------------------------------------------------o----------------------o-----------------------------------------------v
---------------------------B---------------------------E------o-M--------B--E-------?--E------?-------------------------------o---------------------------B-------------E-------------B-----?-----------
----o-----EB-B-----M-o-?-?----o-Bo---oo--Bo--B-ME--?-B---?--MBB------?-----o-----M--E--?-o-?-o-M-M--E----------oB-------B-??X----o--o-----BM-?------------XX----EB-E-Bo--oB-----Eo--?B-----E------------
------oE-------M--M---o--M---E---M---MM--M----M--------ME-?o-XMX--------o--?E-------o-B-------?-----B-E---E--ME-BoEM-o-M---X?B----o-?--oBE------EB------E--X--E-M---EX--XX--MM-?--M--ME---o-------------
----E-B----B-----?o--o--XMX----------M--BE--------E-B-?B------X---B-------B--?o------B-B-T------o-----ME----B-------?X------X----------E-------M--?-o-----X---?--------X-----?---MXBB--?-?-B------------
--oT---X--------EE--?E|-XX---B--------?--E---o----B----E----o-XB?TE-B-?-M-----o------EM-T|EE-E--X-----?-----E----E----XXMX--EX--EB-M-----EoE?--o-E------o?B-M--E----M-X--Xo-B----X--M-------------------
-TT|--|-----E--B---TXE|--XME---?T--TT?TM--|-|-M-|-T-|-XX-E-o-X-T?|----XTT-B-?-BT--|---XM||-oX-B--X-E-|-|--T--TT--XX-TT-X-X---X-MMBX--oE---T--------T-T--XEX-X|---T---XX-XE--M-TMo?XB-BX--?-?-o----------
m|||-||-|--X---|---|-X|--X--B|--|--||-||-X|-|--X|-|-|--XMX-XX|-|-|--|-X||-XX-|-|--|---XX||-X||---X|-X|||--|-M||---|-||--XX|-----XX|-|-X---|---X----|-|--X-|-X|--X|--XX|--XB-BB-B--X---BX-|--X|----------
XXXXXXXXXXXXXXXXXXXXXXXXXXXXXXXXXXXXXXXXXXXXXXXXXXXXXXXXXXXXXXXXXXXXXXXXXXXXXXXXXXXXXXXXXXXXXXXXXXXXXXXXXXXXXXXXXXXXXXXXXXXXXXXXXXXXXXXXXXXXXXXXXXXXXXXXXXXXXXXXXXXXXXXXXXXXXXXXXXXXXXXXXXXXXXXXXXXXXXXX
