--------------------------------------------------------------------------------------------------------------------------------------------------------------------------------------------------------
--------------------------------------------------------------------------------------------------------------------------------------------------------------------------------------------------------
--------------------------------------------------------------------------------------------------------------------------------------------------------------------------------------------------------
--------------------------------------------------------------------------------------------------------------------------------------------------------------------------------------------------------
--------------------------------------------------------------------------------------------------------------------------------------------------------------------------------------------------------
--------------------------------------------------------------------------------------------------------------------------------------------------------------------------------------------------------
--------------------------------------------------------------------------------------------------------------------------------------------------------------------------------------------------------
-------------------------------------------------------------------------------------------------------------------------------------------------------------------------------------------------------v
--------------------------------------------------------------------------------------------------------------------------------------------------------------------------------------------------------
----E-B-?------M---E?----M-------------B------------E--M---o??-----------o--E-X-M--X-?--------B-------M-?M-E-----oME--E------B---------M-------?-B--MT--?--?---------B---?-E-------M--o--?--------o--|--
----B-EMEo-?o---?T-E-?----------?---oo-------E--B-------?-E--?----E----BEo---XM-ET-X-?----E-----E--------?-----B-----B---E?--?--------B--Eo-MT--o---?|o--X?--M--B------E-------E-----oE---o---B---M--|--
-T--Mo--------B--|------B--E-----T----M---?---------M-----B--?---o--B??-?-MXX--MM|?EXM--------EB-??---MBE------Bo--o--E-oo---T--o-?o-oM-B---E|-BEo---|----X-?------o----B-?-------E?-----?M-oB-------|--
-|--TT-o----E----|o----o-----T---|---T-BBo--------T-----MM--T-o-----T----B-X----T|---X-M--?-----o-------------M--------o-----|--E-To-T-------|-------|-----XT-------T---?-M---M--MT----EMX?T---T--o--|--
-|T-||--EEETTTT--|-TBTB---TTT|-T-|-T-|EE------TTo-|B--TT--?-|T-TT---|---E-T-XET-||-ToXB-T-oTTTB-T-T-T----o--T---XT----TT--B--|-T-T|-T|BT-T--T|---o-?-|--M--X|-TTT--T|?X-T-TM-TTBT-|---XEXX-|TT-|ET---|--
m||-||-----||||--|-|-|----||||-|-|-|-|--------||--|---||----||-||---|-----|--X|-||-|-X-X|--|||--|-|-|-------|---X|----||-----|-|-||-||-|-|--||-------|--X-X-|-|||--||-X-|-|--||-|-|----X--X|||-|-|---|--
XXXXXXXXXXXXXXXXXXXXXXXXXXXXXXXXXXXXXXXXXXXXXXXXXXXXXXXXXXXXXXXXXXXXXXXXXXXXXXXXXXXXXXXXXXXXXXXXXXXXXXXXXXXXXXXXXXXXXXXXXXXXXXXXXXXXXXXXXXXXXXXXXXXXXXXXXXXXXXXXXXXXXXXXXXXXXXXXXXXXXXXXXXXXXXXXXXXXXXXX
