--------------------------------------------------------------------------------------------------------------------------------------------------------------------------------------------------------
--------------------------------------------------------------------------------------------------------------------------------------------------------------------------------------------------------
--------------------------------------------------------------------------------------------------------------------------------------------------------------------------------------------------------
--------------------------------------------------------------------------------------------------------------------------------------------------------------------------------------------------------
--------------------------------------------------------------------------------------------------------------------------------------------------------------------------------------------------------
--------------------------------------------------------------------------------------------------------------------------------------------------------------------------------------------------------
--------------------------------------------------------------------------------------------------------------------------------------------------------------------------------------------------------
-------------------------------------------------------------------------------------------------------------------------------------------------------------------------------------------------------v
--------------------------------------------------------------------------------------------------------------------------------------------------------------------------------------------------------
--o---E---B-E---o-?---B---E---E----------E-B----E----BM-----B?-o?----EE-----?---------E-?--?MB--o-B---E----MB-------M----o-----B-------o-B-----------E----M-E----BE----??o---E-B-??-?-------B-----------
-?Eo--Moo--------M-M--------------B---E-E--B---?B-M-----MBX-B----------?--E?--M--------------B----M----B-----B---M------B-----M---B--------Eo----------------B------------?---B--?--E-?------?----------
-?--------oE--o----?------M?B----E-o--?-------oEB-------E--X-M------------M---?------------o-T----E-B--E---?--------E--oE--M--B-----?E--B-XX-B-?---o----EMB-o-E----------B--EM---E-?-X----E-M-----------
---?----B-B-M-TMB-B--TBEE----T-------o---B----o-----?----T--X-----?-E--E---?--o-T----MB-?EB?B|oT-M-?------BB--E?--MXE-EM-T?---Mo--M-o----BX?X------o--ET-T-------BoB-----?X----M----X--?o---B-----------
-T-M-TT---TBX-|--XTM-|-TE--T-|TE---TT-X--T-TT-?-?-MX-X---|-MX---TE--B-MT---oTT-E|-------T-E-M|-|-MX--T-M-T----B-?-XM---XX|TT--X-?BT---?---XX-T---oE-Mo-|T|-TT------TX--B--X-M--------X----ETTT----------
m|---||---|--X|--X|--|-|-X-|-||B---||--XX|-||-------X-X-X|--X---|--XX--|----||--|------B|--X-|-|-XB--|-XX|---------X----X|||---X--|----X--X--|---X--X-X|||-||----BX|-X---XXX-X-------X-B---|||----------
XXXXXXXXXXXXXXXXXXXXXXXXXXXXXXXXXXXXXXXXXXXXXXXXXXXXXXXXXXXXXXXXXXXXXXXXXXXXXXXXXXXXXXXXXXXXXXXXXXXXXXXXXXXXXXXXXXXXXXXXXXXXXXXXXXXXXXXXXXXXXXXXXXXXXXXXXXXXXXXXXXXXXXXXXXXXXXXXXXXXXXXXXXXXXXXXXXXXXXXX
