---?-----EoToMMX--E-M---?---M-B--T-|--XX---?--EE-E------X?--M|?T--BEB--T--B--M--|-X----?-M-||?-o--TB--M--T--B---ET-|?----Mo-?X-B-o-|-T-|M---X-B-------MMEEBME-o--BM||---E--o||--Mo-T---EXBTE---XX---|---
--X|Eo-----|X----TM--|-B-T--M?--BX--E-oT------B----XBT----o---------------X--TXBX-M---BEX----ETBT-B---B---X--T---M---?|B---Bo--?---X|-?-------TE|M-?X-XBo?--XMoM--|||--|-----o-M---oMXo--|---------B----
-|Mo?o|BTMM-o-T---T--ToEBM?----?E?M------X-oE---ET----?---|-TT----M|--|-M-?B-B|?M---MBB----T-----|T-o?-----XX-M-Xo---------oX-E--MB--T-B-o---------M------TE--EMT---M-?XBM|--M--TTXMM----|----M-o-X-TE--
-----ET-M--------|MM-MT----BMX--E-----E-X-T--oM--T---?ToEoM--M------|E--EB--XB----T------EEM--T-EEo-M-XXME-XE-E---ET----X-oT-o--T|-|XT-oEX----?X--|----M?B--??-ME--|Bo-X|X-E--o-X--XEB?---------|MM-----
-B-XB---M--T-|Mo-X?-X-TMB-ME-X-T||o-|-E---M|--XM--X-X--B--TBB-----?--X---M-|--Bo-EMo--X-B-EX?-T--?MB-----T-B----?--?--MTo--X---|X--|-----MoEM-B--|-B--B----o-oE-E-------?-E|---?--BXo|-ETX-B---T----|---
--?---------X--X------X-X-|--?B---T?-B----X?MB-X---X-E-----T-X-X---EB--BM-----EE-------------MXXM-E-o-|?B-E?B?--T-?-X-To?E--o--B-?E-?----T----XM-ToM-o|-E-?---T-B|E---?T---E--|-M?---o-|-o|X---|-|??-|--
-E--BXM-B----o---|TE-?--?-T-?T---?-TB-M--|-To-M-X---??---MT-B|-B-B--BBT-MXME-|-E---EB---B?oo-o--------XE-||-T-X---o-XoEB--X--|--ToM|M-?---X|?--E----T-BEXE|--M---Xo-B--M-----E-?E?--Bo-E----T---T--|-?--
-E-|----X--o--o---o--XE----E----|-|M-oE-oXMM----E--?---E---X-XMET--XE-o-oM-|---o--|----M?X-M--?-M-B-X-oT-EE|T|-E--X-X---oXMTBT--X--ME--B-M--ETB?o-T--X|---M--|--|--X---------?|?B-|-----B--?---B---BoMov
--o-----------M--B----X---B---EE-T----B-X|----Xoo-XB?-|XB---B---|TE----o-o-------X------XM-MBMo-------E--------?-?-?B-oE--XM--E|---XME-X----oB?o-oMM----o-?--|BoooB---T---o-?----o-M-MB--X-X---EBB-T-MXf
---TM----Eo-o---oX-oB?---|-o-B-M|-----?M?---MX|ETE-?oT--|-E-E-BXXMB-o-E-BM---M-----o--BMBB--B-o-M|--?--B-----B|-M---------|-B-?-EBoE---?o----?E--B-EM|--TE-M---|--E?-E--B|--B?----ToE--?|----o-B--?-EM-f
---B--------?--|M-o-|M--?-TTTT---oBE---?TB--o?--?-??-----EX---------E|-MXM--?-------XM-?-BTX----------X-X------E---?M-MT|--?EB---T-B?---o--?--|E-X-|-X-T--E--T-oXME?BEM-E???----E----X-------MXT?o---o-f
-ET?--oM|-----T--T--X--BB-BMBX-X-|-oTXB|o-oEE|-E|o---?|--T-oXo|---|-MM---ETB----o--M---B------o-ET-|X-EX--E----EM--BME------B-----T-E----X--|-X--|-----|-|-?-|TX-E-B-B??--X-|-M?--o--o|B----T|-o-X-MB--f
--BM-X--M?-M--oX?-EBT-||oo-|MX|--?-----M-EBT-oEo-oT-X-|-M--?-----o?X----ToM---------T----Eo-----T-----MM---B--M|?-X---o--T---|-M-oEB-----B--T-Eo?T--XMEM-----E|-XT---?-----T-X-MT-T------B-|-BXT-MB-T--f
--o-B--?-M-Mo--M-B-?T--E-|-M-T--B-o-----TTEXT?--E-MX-----M-M----o-M-B----|--|o--M-|----T-BT|-TT----o-?T----|E-EX--oo--T-T-T--X-|-X----MM-B--TEX--BB-?------M?--M----M---M---|M---oE-o-T|---EMX?|--TM---f
m-E------?E-|-o--MEEXoB--B--MTo-?-TT------M----?-ET?-T||--oX-|-E---X?E---|BoTEM-T---|-B|M-TM|-T-oXT?----?--|-?-MT-M-ME-E--XT-o-BTo-?----o---T---X-----o?M?--T-X-Bo-|--|--?-?XM-|-?--MB---BB-B-XBM-----?X
XXXXXXXXXXXXXXXXXXXXXXXXXXXXXXXXXXXXXXXXXXXXXXXXXXXXXXXXXXXXXXXXXXXXXXXXXXXXXXXXXXXXXXXXXXXXXXXXXXXXXXXXXXXXXXXXXXXXXXXXXXXXXXXXXXXXXXXXXXXXXXXXXXXXXXXXXXXXXXXXXXXXXXXXXXXXXXXXXXXXXXXXXXXXXXXXXXXXXXXX
