--------------------------------------------------------------------------------------------------------------------------------------------------------------------------------------------------------
-----o-M----------------------------EB--------------------------B--B--o-----------E-----B------------M----------------oo-B------?------o-------E-----------------B--------------------------------------
----------?--------------M------E---------------------------------B-------?-------?----E--------------------------o---------M-----------------------------o--?-------MB-----Eo--------------------------
---------------------------------------------------------------?--------------B------------E-----M-MB--------------------o--------M-----?---------------------B---------------B-------------------------
-----------o------E-------------MB------?--------B------------------------------o---------------M--------------------------------B-----------------o--E-M----------------------------?-E----------------
-------?-----------------------------------o------o-------o-------------M-----?------------------------------?---------------B--------------------o-----?---------M-------------------------------------
---------------M----------B----------------------------?---------?-----------------------------------E---------------------------?-------------?-----------------o---M--------o-------------------------
----------?----o-----------B---------o------------------------------------E----E----E---------------------o-------------------------------o-----------B--------------o------?--------o--E---B----------v
-------------E------------------------M-M--E----?---------------------------------------B---------B--------o------------B---------B------------E------M-------------------------E--B-B-----------------f
-o-E------o?o--B-o--?--M----------?-E--------M---------B--------------M---?-------E------------EoE--B------MXo-E-E-----oE----?----E-M-B---B-?-E---o---?--B--M-M--B--o-------o----------BE--------------f
----?-M-o---------E--------o-----------o---oX----E-------EE-M-----B-X--?--E------B--EE---E-o-M----E----?--M--X--E----B------BB-X---E--E?---E---o---?M-B?-------M---??M-oo-E-----oX----o---??-----------f
--------M-------E--------------------B---Mo---XM---o?o----------B-oX?B----o-----------E-------oo--o-----EB----EB-E----M--------?Xo------------o-B-?---M-M-E---MX-?--T--M-------E?X--E--M---?-----------f
---T-----o--?EE-------M--BoT--B-B-?--M--?-E?-X-?--EX--o---E---X--XX--o---?-o-----------M----B--------?----B-E-XBT-M---XEET-T---XX-B-M------o--?-o----?--o-Eo---Xo-B-|-B------X-o-T------M----E---------f
--B|-T-T---B-?-XBX-X--?ToTE|TM----TB-MB---T-TTE---X-T?-T-TT---EXX-XTTBB-?T--MM-T----T---?--TT---oXXE-MX-----X-BX|--X--XET|-TM-XX-Xo----o-T---XTM-?-?TMTT---EM--TX--T|--T--B-X--|-|oEME-X?-?--T---------f
m-?|-|-|---BX|--X-----B|-|-|--X---|--X-|--X-||-|-XXB|--|-|---X-X-X--|--X--o---X|--|----BX--||---|-XXXBX--X-XB---|----XXX|--|--XBX----|-X-|--MX|---|---||-------|-X-||--|-------|-|-Xo--XX----|---------X
XXXXXXXXXXXXXXXXXXXXXXXXXXXXXXXXXXXXXXXXXXXXXXXXXXXXXXXXXXXXXXXXXXXXXXXXXXXXXXXXXXXXXXXXXXXXXXXXXXXXXXXXXXXXXXXXXXXXXXXXXXXXXXXXXXXXXXXXXXXXXXXXXXXXXXXXXXXXXXXXXXXXXXXXXXXXXXXXXXXXXXXXXXXXXXXXXXXXXXXX
