--------------------------------------------------------------------------------------------------------------------------------------------------------------------------------------------------------
--------------------------------------------------------------------------------------------------------------------------------------------------------------------------------------------------------
--------------------------------------------------------------------------------------------------------------------------------------------------------------------------------------------------------
--------------------------------------------------------------------------------------------------------------------------------------------------------------------------------------------------------
--------------------------------------------------------------------------------------------------------------------------------------------------------------------------------------------------------
--------------------------------------------------------------------------------------------------------------------------------------------------------------------------------------------------------
--------------------------------------------------------------------------------------------------------------------------------------------------------------------------------------------------------
-------------------------------------------------------------------------------------------------------------------------------------------------------------------------------------------------------v
----?--E---------?-----?--??-o--oE--E---?-?E?--------E------?------?--------?--?-----E-?------E----E?---E?-E-?-E-?-?-?--?---------?-----?-------?---E---oo---E-o---o?--------?------?-------------?---?-
-------o------?---E-------?-------------------?------------o------?------E------?---E------------------E----o--?--?E---?--------------------o--?--E---------EE-----o----?--------?---Eo-?-----?o-----o--
-------?--??E---E?-?-------?-----ooo------------?--?-?E----?------------o----?o-o------------o--E---------o--------?-E---------------E-----o-----E--E---?--?-?------------------------oE-?--------------
---?--?----------o---o--?--------o--?---------o------?--------?--o-??-E-----o?-E--?-o-E--?E--o---??-o-------------?-o?---?-----o--?--E-???o------E-----o---?--------------o------?--??--?---o??--E------
-------o--oo?---E-o?------------??------------EE---------?---------------?--------E----E-E---E--------?------EE------o-------?---------?--------------o-------------?------------------?-o--------------
--E------?--------E---?-------o------------?---o-------------E--------o----E?----------o--oo-----o----?--E--------o-?-----?--------?--E------------??E------?-o----E------??E----------?--?-------------
m--X?XX-E||X|??-|-E||---E--o--?-X-Xo-X-EX-?--|?Xo-?|X?X|--|EXo----|X-o|E-o-X--X-?----X-X|-----X?X-oE-E-X--XXX-?X-E|-XXX|X-X?--?X--|---?-X?X-Xo?X?-XXX-X-|X-X-X-|-|o--X-----X-|--XXXX---X----E?X?---|--X-
XXXXXXXXXXXXXXXXXXXXXXXXXXXXXXXXXXXXXXXXXXXXXXXXXXXXXXXXXXXXXXXXXXXXXXXXXXXXXXXXXXXXXXXXXXXXXXXXXXXXXXXXXXXXXXXXXXXXXXXXXXXXXXXXXXXXXXXXXXXXXXXXXXXXXXXXXXXXXXXXXXXXXXXXXXXXXXXXXXXXXXXXXXXXXXXXXXXXXXXX
