--------------------------------------------------------------------------------------------------------------------------------------------------------------------------------------------------------
--------------------------------------------------------------------------------------------------------------------------------------------------------------------------------------------------------
--------------------------------------------------------------------------------------------------------------------------------------------------------------------------------------------------------
--------------------------------------------------------------------------------------------------------------------------------------------------------------------------------------------------------
--------------------------------------------------------------------------------------------------------------------------------------------------------------------------------------------------------
--------------------------------------------------------------------------------------------------------------------------------------------------------------------------------------------------------
--------------------------------------------------------------------------------------------------------------------------------------------------------------------------------------------------------
-------------------------------------------------------------------------------------------------------------------------------------------------------------------------------------------------------v
--------------------------------------------------------------------------------------------------------------------------------------------------------------------------------------------------------
----X-XXX?o-?---?-XX---o--------E-?------?-------E-----?----?---o?---?X------?X-X-----E----??-----E?----------?----------XE?----E----o----o-------?------XX-X-----------------?-Xo?-?------X----??--o---
--XX--oX---------EX-E-?--E---E?----o------?-X---E------Xoo-----EE--E---X---X--oX----E-----------o--?-----------E-----E--?-X-?-----------??---------?----X--XXX-----?E-----?----?-Xo---X-o?oXX?--X???----
---X?---X---------XXX---X-E---oo--XX--?---o-X----?E-X-X-EE---E--?-------X--X?XX-----?-?-?---?-o-X--------?----o---E-----EEXX--o-------E--XEX-E-----E----XE--X-----------------?-EXX--o-X-?oXX---X?------
-?-EXX-XX-E--------X---?-XE------XX--Xo---XXX---?----X?-?-XE-----------oXE?-XX-o-?o?----?-o---X?XXE--E-?-------o------?-?XXX--?-?-----o-X-XE-----XXX?-?-XE?X--------?------o-?---X?-X?-EXo--X--?-X-E-?--
--ooX?-oXEE?X--o---X-X-?XT-------X-?-X?XXX--X-E----?--XX-X-E------o-?E-EXXXX-X?-??--T-Eo-o--XXXEX--?--X-----T-o---?---To-TX----XEXX-?-??-XE?---XX-?X---EX-XE?-----E--E--E--?--TTX--X-X-E-X--Xo-XX??X-?--
m--EXoE-XX-XXoE--?|oX---X|oo--XE-X?XX-X-?XXXX-|?X?---XEEXE-E-E--XX--XX---X-?X-X?Xo--|--X?|-X?-XX-o-XEXXEX---|---|---?-|-X|X?o-XE-|X-X-X--X-XEX--X--X-?E?-XEX-??-----o---|XXEX-||-X?-X---X-?XX--X-X|-X---
XXXXXXXXXXXXXXXXXXXXXXXXXXXXXXXXXXXXXXXXXXXXXXXXXXXXXXXXXXXXXXXXXXXXXXXXXXXXXXXXXXXXXXXXXXXXXXXXXXXXXXXXXXXXXXXXXXXXXXXXXXXXXXXXXXXXXXXXXXXXXXXXXXXXXXXXXXXXXXXXXXXXXXXXXXXXXXXXXXXXXXXXXXXXXXXXXXXXXXXX
