--------------------------------------------------------------------------------------------------------------------------------------------------------------------------------------------------------
-----------------------------o--------------o----?-o--M-----------E----------------M-----------M---?------o-----------------?---------------------------------?-----------------------------------------
-------------------M---B---------B--E--------------------?--B--------M-----------------------?--------------M--------o-----M--------o-------?E---------E---------------E-----------B------?-------------
------------------------------?---------------E----------E----------------M--------------M------------------MM-----o---M?---o-------B----------B--M--------------B--------------------------------------
-----M----------------------------------?-----E------o----?M-E?----------------?-----------------------------------------Eo-----?-------------------?---------------B?----------------------------------
-------B----------------------------------B----o-----------------M--------?--------?--------------B--------------M-----------------------------BB----------------E-----?--M---------?-------------------
----------------------B-B--------------M-?-----?----------?--------------o---------------------------o-----B---------------------B-------------?----Mo--M-----E--?-o----?--?----------------------------
--?----?----M---------?--------B--------------------B------------o------M-----------M--------o---------------------------------------------o------------M-----------------?---E-M------?---------------v
--------?-----------E--------------B---o-------M--------------------------o-B?--o--------------------------------M----------------E------E-----------------------o---------E---------------------------f
----E---E-----------oBEE---BBoooX------------B--------------B----E----M----B?-----E---B--EE?-B---M----ME--Xo--------E-E-----BM--o-?-E-?----BM------------E-?X?M?---B-----Eo-M--oo--o?-M------B---------f
-M--BEEM---M---B-----B------BM-X--M---M--o---E-?---E---?---------EB--------?---o--------X----------EMo-?--B-------?----B---M-M------------------?M-?--o--E-B-XX--EM--M---M-M?M------------E------------f
---MEo------o--o-----o--M-----X?--BE----o-----------------?-------o---------oB---------XB---o------E----X--o---B----------?--BoM-------------B-?--ME---o--BM-M--M---XX-oo-X---M--o-B?X-Mo-M------------f
--MET-T----BM----o-?---M-B?---Xo--------E-----BE---BM-M--T--B-----------o----o---T--B---XXX-o---------BXoo----M---oB-B----E------o---B--------------------oBX---M---X-B-?--X?---M--BMXTT----ET---------f
--MT|-T--BTMB-B--X---M-?-?T--Xoo--BX-ETo-T-E--?T-TT-----M|?----X-T-XE---T--T----T|--X---X-X-B--X--?TXXXXX-oT?--X--B--ET----|---???E------T--T--o-TT-X-oooBE?XB-T-T--TX-XX--X------M--X||-----|---------f
mB-||-|---|-X---X-------|-|--XX-|--XX-|-M|-|--X|-||-----XXB-X-X-X|--|---|--|--|-|--X-X-B|--XX--X--X--X---MX|-B?X-----X|----|--X--XX-||-X-|--|--B-|||-X--XXXXX-X|-|--|-X-X-|----B-X--X--|---XB|---------X
XXXXXXXXXXXXXXXXXXXXXXXXXXXXXXXXXXXXXXXXXXXXXXXXXXXXXXXXXXXXXXXXXXXXXXXXXXXXXXXXXXXXXXXXXXXXXXXXXXXXXXXXXXXXXXXXXXXXXXXXXXXXXXXXXXXXXXXXXXXXXXXXXXXXXXXXXXXXXXXXXXXXXXXXXXXXXXXXXXXXXXXXXXXXXXXXXXXXXXXX
