--------------------------------------------------------------------------------------------------------------------------------------------------------------------------------------------------------
--------E----------------------------------------------------------------E--------------------o---------------------o----B----------------M-M----------M-------------------------------------------M----
--------------------o--o-------------------------------------------------------------------B---------------------------------------------------------------------------------------------o--------------
---------------------?-----------B-----------------------B---E-------------------------------------------------------------------------------------------------------------B----------------------------
-----------------------------o-----------------------------------------------------------B---------------------------------E--B-M-----------E-----------------------------------------------M-----------
----------B-o---E----------------------?------------E---------------------M-----------------o---------M-------B--------------------------------------?------------M-------------------------------?-----
----------------------------------------------------------------------------------------B-----------B--------------------?------M--E-----------------------------------------------------E----------B---
----------------------------------o-----------?------------?---------------------------o--------------------------------------------------oE-----------------------------------------------E------B----v
--------------------------------------------------------------------------M------------------------------------------------------------------------B-----------------------B----------------------------
---MM-----Xo----oB----BE?--E------------?----MEXE-?--M-------------M-----M--EB-B---B-----B----??-------X-BBX?o-----E--B---M--E--o-M-----X--B----EME-Mo--------M?--M---M--E-M-o--E-o---M------?o---?--o--
----?o--XXM----o---E-?--------?---B---o-----?---X----EB---------------o---B--?---oB-E------?-----?--MoE-X------M-BM-----------B---MB--E-M-?--------X?-o-?M-----E----E----EoXo--EBB----?-o--XXX----------
-----o---------B--XE--B--o----o----M--------M-E---------------EM---------o-oE--EM----?B------o--B--B?----X-MEX-----o--?---B---?-----?----X----X?--E?XBE-B-----------M--o-B--X-M-?---------XBX------E----
--BE--B--EM----E??X---M--o--o---------------?-XM--oB---E---o----oB-----?----B--EM-B-------?M-X-X-------E--XXX-B-------M-o---------o-------X-B-X-X--XB---?-E--------o------X-EX------XMo--?-XM-B-----X---
--?-M--XXX---?X--X--?--M--X-E-E--o-E------------X---?-EX--M--X--o--o-B--B--?E-X?B--oE---MM--M-X---B----Eo-X---X--?-??M-B----oX--?-o---E-E-X-MoXMEMXB--XX?Eo------B?-----MXo-X----E?--XM---X--X-XBo-?-X--
m?-M---BXMX--BXB-XXX----BX--X--X--X|?--oE----B-X--X---XBMX?-XB-----B--X-oXM-XX-------oXX-X-X---X-X---?-----X?--X-X-X?-----MM--XX-o-------EX---M|XX?--BBXEE-M-o?----XE-M--XEX-X-??----X??-X--X--X|--XX---
XXXXXXXXXXXXXXXXXXXXXXXXXXXXXXXXXXXXXXXXXXXXXXXXXXXXXXXXXXXXXXXXXXXXXXXXXXXXXXXXXXXXXXXXXXXXXXXXXXXXXXXXXXXXXXXXXXXXXXXXXXXXXXXXXXXXXXXXXXXXXXXXXXXXXXXXXXXXXXXXXXXXXXXXXXXXXXXXXXXXXXXXXXXXXXXXXXXXXXXX
