----------------------------------------------------------------E------------------------?----------------------------------------------------------------------------------------------------------o---
-------------------------------?--------------------------E---------------------------------------------------------------------------------------------?-----------E------------------?----------------
----------------E---------------o------------------------------------------------------------------------------------------------------------------------?--------------------------?-------------------
------------------------------------------?----------------------------------------o-------------------------------------------------------------------------------?------------------------------------
------------------------------------o-----------------------------------------o-------?-----------------------------------------------------------------------------------------------------------------
--------------------------------------------?------------------------------------------------------------------?----------------------------------------------------?-----------------------------------
---?-------------------------------------------------------------------o----------------------------?------?----------?--------------------------------------o----------------------------------o-------
------------------------?--------?----------------------o---------------------------------E------------------------------o--------------------?---E--------?o--------------------?---------------------v
------?---?---------------------?------------E----------------------------------------------------------------------E----------------------------------------------------------------------------------f
---------------?-----------------------------------------------------------------------------------E----------------?oE---------------?---------------------------------------------------?---------?--f
-----------------------------------?---------------?---------?------------?------------------------------E--------?-------------------------------------?--------------------------------------?-------f
----o------------------------------------?-----E------?-----------------------------------------------------------------------E--------------------------------o---------------------------------------f
-------?------------------------------------------------------------------------?------------------?-------------?------------?-------------------------?------------?---------------------------------f
--------------------------------------------------E-----------------E-------o-----------------------------------------o------------------------------------------------------E-------?-----------------f
m|------------------------------------------------------o--|---|---------|--|---|--------------------------?---|-----|--------------|-----|--|----|-----|------|-|---|------|-----o--------------------X
XXXXXXXXXXXXXXXXXXXXXXXXXXXXXXXXXXXXXXXXXXXXXXXXXXXXXXXXXXXXXXXXXXXXXXXXXXXXXXXXXXXXXXXXXXXXXXXXXXXXXXXXXXXXXXXXXXXXXXXXXXXXXXXXXXXXXXXXXXXXXXXXXXXXXXXXXXXXXXXXXXXXXXXXXXXXXXXXXXXXXXXXXXXXXXXXXXXXXXXX
