--------------------------------------------------------------------------------------------------------------------------------------------------------------------------------------------------------
---------------------------------------------M----------------------------E--o-----B-----------------------------E-?-------------------------------M----------------------------------------------------
---B-?----------------------------------------------------------M---E---------------------Mo-----M-------------M-----------------------------M------------------------o--M------------------------------
---------------------------------------E----------------------E---------------------------------------------------------------M-------------o-----------------------------------------------------------
----------------------?----------------------------------M--------?---------------------------------------------------B------?---------------------------------M----------------------------------------
----------------------------------------------?-------?--------------------oB-------?-------------------------------B---------------------------------M--E----------------BB-E-------------B------------
-------M--------------------------------------------------------------------------------B-----------M-----?-----------?------------------------------------------o-----M---B-------B----?--M------------
------------o---------------E---------------------------------?-------------------------------------o----?----------------B-------------M--?---E--------------------M--------------------?-------------v
-------B--------------------------o-------?---------------------------------------------------------------------------------------o--------M-----------------X-------------------------o----------------
-o------X--E---M--B---B--M--B-E-----X--E-B----E--------M-?----?E--B-B--ME-----------EE----?B--E-E--------------------B--E-BM-o--o-M----------X-E-----o-o----MXB---------M----B--E?-E---------B-E--------
---------X---M---BB-----o----o---o-B-X-X---?---------Mo---E--------E--------E---M--oMXB--XXM--o-----?BE--M--------?----E----?M----M-----------X---E-------M--X-----------M---B-----E-M-----o--X---o-----
-----?E--EX--B---o----BM-BEo---------X-X-B--BM?E?--?--?oo----M-M--------o?---E-----XX--?--X------o---o-------?--E-----o-----B-Bo--o---Xo-----X-XB--E----XX--X-o-----o------------M--Bo-?-M-BX--X-M---E--
-BB--B---XX---M-o--M--X-B-E----o-----?XEBE--B--B--E--EBM------o--B--B--B-BBB----E-B-XM?BE--XM-----o--MB----?---M--Eo----X-X-----?-o--?-X---?o?X--B-----B-X---X---------BM-----MB-----X----XXo--EX-B--E--
--E----M-X-o-oBEo?----XB---EB-E-----EX--XBM-o--B-B?-----------o--E---Bo------------XX-o--BX---?-o----o----E----X----o-E--X------M--MBE-XX-M----EXB-----oX-o-X-XEB-----M-----M---?-B-X-Mo---X--XX-E-MX---
m--X--o-MEX-X-E-o-XEB-X?-?---o---B-?MXE-o------ooo-B--X--X-X|--Xo----X-X---o-----M-XXX--X-?X--MX-EXB-X--XX--oXX-M--------X--B?-BX-X?-XXXXX-o-BX?-----X---XXEXXo-B-Mo--o------EX---BX|X-X----X--X---X----
XXXXXXXXXXXXXXXXXXXXXXXXXXXXXXXXXXXXXXXXXXXXXXXXXXXXXXXXXXXXXXXXXXXXXXXXXXXXXXXXXXXXXXXXXXXXXXXXXXXXXXXXXXXXXXXXXXXXXXXXXXXXXXXXXXXXXXXXXXXXXXXXXXXXXXXXXXXXXXXXXXXXXXXXXXXXXXXXXXXXXXXXXXXXXXXXXXXXXXXX
