--------------------------------------------------------------------------------------------------------------------------------------------------------------------------------------------------------
--------------------------------------------------------------------------------------------------------------------------------------------------------------------------------------------------------
--------------------------------------------------------------------------------------------------------------------------------------------------------------------------------------------------------
--------------------------------------------------------------------------------------------------------------------------------------------------------------------------------------------------------
--------------------------------------------------------------------------------------------------------------------------------------------------------------------------------------------------------
--------------------------------------------------------------------------------------------------------------------------------------------------------------------------------------------------------
--------------------------------------------------------------------------------------------------------------------------------------------------------------------------------------------------------
-------------------------------------------------------------------------------------------------------------------------------------------------------------------------------------------------------v
--------------------------------------------------------------------------------------------------------------------------------------------------------------------------------------------------------
-?o--?--?------XX---?-----o-----?-?--?-------?---E---XXX-X-E----EX--EXXX-?---o---X--o?-XX--?XX------?----E--X-??X------E-E?o-?-Xoo----------?--------o----??-------?---??-?-o---E-o---X?---o-X---o------
------------?---X?------o??-ooo------?oo-----E--?-----XXX---XE--X-EE-?X?-?-?------XXEXXXX-X?XE-?---------XEXX--X----o?------?XXX--?-E---E----?--------------?-o-----X------EX----E?--o-XX---XE?----o-E--
----?---?--?----X------?-?-?-?E?-?--E-X----E--?-----?X--X---?X-X---X?X-------?---oX?-XXX??XXX----o--?-----XX--X------E---?----X??-----------------o-E---o?----E---?--X--??-X--E?--??--?X?XXEX--?-----o--
--------?o-E--ooXX--?----------------XX-------X--o--?X?E-XoE--X?o--oX?------?-E-?E-X-XXXX--X-?----oEXEE----X-XE-------??--o-?--X------E--o--XX---X?-?-------------?XX-XX-X-X-EE-----o--XX-XoXXX-XXE-----
------XXX-X-o-Xo-XXX----TE-oTE--E--E--XX-XXXEXX-?----XX---X----XE---?XX---E-T---oX-X--XXX-X---?----XX--T?-?X--Xo----E?----E--XXX-T-o?---T--?X--?-Xo-?--o------T--EE-XXXX-X-EX---E-E--EXX-XXXX-X?XXXX-T--
m---X-?X--X-XX|X-EX?-X--|-o-|-XX-o?--ooXXX-X-Xo-XoE?X?-XoX-----X|--X-X|o-E--|X--oXX|--X-X--X-E-X?E?X--X|E--X-X?-oXXX-XX-?X-??XXo-|XE-X--|----X?o--X-?--|X---Eo|----XX--XX-XX?---X--Eo-X|-XXX-?-XX?-X-|--
XXXXXXXXXXXXXXXXXXXXXXXXXXXXXXXXXXXXXXXXXXXXXXXXXXXXXXXXXXXXXXXXXXXXXXXXXXXXXXXXXXXXXXXXXXXXXXXXXXXXXXXXXXXXXXXXXXXXXXXXXXXXXXXXXXXXXXXXXXXXXXXXXXXXXXXXXXXXXXXXXXXXXXXXXXXXXXXXXXXXXXXXXXXXXXXXXXXXXXXX
