--------------------------------------------------------------------------------------------------------------------------------------------------------------------------------------------------------
--------------------------------------------------------------------------------------------------------------------------------------------------------------------------------------------------------
--------------------------------------------------------------------------------------------------------------------------------------------------------------------------------------------------------
--------------------------------------------------------------------------------------------------------------------------------------------------------------------------------------------------------
--------------------------------------------------------------------------------------------------------------------------------------------------------------------------------------------------------
--------------------------------------------------------------------------------------------------------------------------------------------------------------------------------------------------------
--------------------------------------------------------------------------------------------------------------------------------------------------------------------------------------------------------
-------------------------------------------------------------------------------------------------------------------------------------------------------------------------------------------------------v
--------------------------------------------------------------------------------------------------------------------------------------------------------------------------------------------------------
--?----XX-?-EXX--E----E----?-??oX-X-E-E-----X?--E?----?E?---?X-X---X-?--?-XX-o-EEo-??o-----------?-----o----E----------o-EE-------X-------?-?---X-X??-XX-X-X-----------?--XXXXEE------X---E--o----------
-----oo-X-X--X---?E-o----E------XX-??E----XXXE-------------o-XXX??-X-?-----X-E-----E-------o----------o-?---E----oo-----o-X?----X?X----E---------XX-o--X--XXE??-E-?o-X----XX-XX---oo---X----o??---o-----
-----o-E-X?XX-------------o-----X--------oXX-------E---?-?-?--XE----XXX-XXXo?o--??--?---?---?-----------??---------o-?--E--X--?--X----------------X--E?X-XXo--------XoX--oEX--X-----o-?XX---EoX--?------
------oXX-oXX----?---?------?--?X----?----XXE-------X?--XXX----X-o-?-XX-X-X--E----??o-?-?-------?--o----??---o------X--E?--X--oo--X--?---X---E-----XX--XX--XX?-------X---oXEXo-X------XX-?E-EXX-?-------
-o---X?XXX-X----T-E?-----o?----TX-----E---?XE--?-TT-X-Eo-X-X-XX----?oX---XX?o--E?-TT-------?-T------?EX----T--?----XE---XXo?X??--XXXX----X?oo------XXX?-X---X-X?-?--EXE-?-X?XXX?-------X-?TT--X?---TTT--
m?-XX-XXX---X???|?--XXE-??-----|X---|?----XX----?||-EXXE-?XooX-E--XEXo---?X-|---XX||?----X--||oXX-?-XX?o-XE|-EX----X-----XXXX---X--XXX---EXXXX?-?--XXX|X---X--X|---?--XXXX?X-X--?o---EoXX-||--X?-o-|||--
XXXXXXXXXXXXXXXXXXXXXXXXXXXXXXXXXXXXXXXXXXXXXXXXXXXXXXXXXXXXXXXXXXXXXXXXXXXXXXXXXXXXXXXXXXXXXXXXXXXXXXXXXXXXXXXXXXXXXXXXXXXXXXXXXXXXXXXXXXXXXXXXXXXXXXXXXXXXXXXXXXXXXXXXXXXXXXXXXXXXXXXXXXXXXXXXXXXXXXXX
