--------------------------------------------------------------------------------------------------------------------------------------------------------------------------------------------------------
-------------------------------B---------------?------------M---------------------------------------M--------o-------------------E----------o---o---------------B-------------------------------B-------
------------------------------?----------------------------------?-------------------------------------------M-----?------------------------B--------------------------------------------?--------------
----------------------------?----------------?------------------o------------------E--M-------?--------------------M-??------------------------o-------------?-------?--------?-------------------------
----------------?----o------------------------------------?-----------B------------------------E--------?--------M--------o-----------------E-----------------o---------------?-------------------------
-------------B---M-------------------------------------?--------E-----------------------?------o----------------------------------------------------------E----------?----?-----?-----------------------
----------------------?---oo------------E-----o-M-------?-----------------------------------------BM---------------?----------------------------M-----------------------------M-------------------------
------------------------------------------o------------------------o---?-------------------B-E-----------------------------------------B----------------?----------------------------------------------v
--------o---------------M------------------------------------------X-------------------?----------------------------------------------------------B-----?---------B-------------------------------------
--B------------E-EoXE-E?---o-----XE--E--M-E-M---------B?------o----Xo--MM-o-X-B--BEo-B?-----B-E-------E-Eo------M---oXoXB--E----MM---M--o-B--o-----E?BXX--M-----M----oo------B-B---E--M-----------BEEM--
-o--E--M----EM---X---?-B--B---E--XMo------------?BM--B-----B-o---M-X--------X--M-E------B---EBM-E---E?---M---------EEMXXX?--------o--?-E-M--Bo?-----BE-X?-B-XE--------X-X----?--------E--E--------------
-------MMo--------XX-------o---X-X--EBo----M-----XoX-------Mo---M--X-M----B-X--?-----?------M?---B--X-o-----M----M--?oMXXX-----o---o-------?-EE------oXXE--BX--E----M--XM?--?--?oE------B---------Eo-M--
----??M-B-?MEB----MX-----M--X?XX--X-------B--?-XX--EX?--M-?-X------X-?-E--B-X--M-o--E-B-E---------B--Xo----BE-?----?--X-X-E-------o-E-------------oE-XXXX--X-?--B---M-Xo--?o----B-B--B------B--E-B------
---EE---B--oB-X-?B-X-M-?E----XXX-XX--o-X--X-XX-X---MXX-------X-MX-XB-B----oXB--BMM--?E-----MEB-XX---MMX--------------MMX-o-X-M--B?--o---E--B---X?----X--B--X-B--------BX?MXo----E--o----------oB---X?B--
m-X-M-----M--X-o-X?--X?X-----?XXXX---MXX-X-M-X|M----X----XE?-X|X-XX-E----XX-----E---XMBBE-E--X-X-?o---XM-XBo-XE-o-E----XXM-XMX--XBX-?-----?----X-X----oE--?--Xo-?-E-?XXX-X--E---MXE|E---MoX--B-X-EE-X---
XXXXXXXXXXXXXXXXXXXXXXXXXXXXXXXXXXXXXXXXXXXXXXXXXXXXXXXXXXXXXXXXXXXXXXXXXXXXXXXXXXXXXXXXXXXXXXXXXXXXXXXXXXXXXXXXXXXXXXXXXXXXXXXXXXXXXXXXXXXXXXXXXXXXXXXXXXXXXXXXXXXXXXXXXXXXXXXXXXXXXXXXXXXXXXXXXXXXXXXX
