--------------------------------------------------------------------------------------------------------------------------------------------------------------------------------------------------------
--B-----------------------------------------------------B----------B----------------------o---------------E-------------B--------------------------------------M----------------------------------------
-o----------M--------------------------------------------------------------M-----------------------------?------------------------------------M-------------------------o----------------------B--------
---------------------o---E------------------------E--M------?--------------------------------------------------------------------E------------B---------------------o---o---E-------M-----------B-------
---------------------------------------------------------------------B---------------------?-----------------------------------------------------o--------------M------------------B---M----------------
---B-------------o---o------M-----------------E----------------B--------------------------------------?------------------------B---------------------?---o------------------------M---M--?------------o-
-----------M-------M----------------------------------------M----------------------------?--------------------------------------------------------M------------o------------------------E---------------
-------------B------M----?---M-------E----?-B---------o--E---------------------------------------------------------------------o------------o---------------------------E--------------------------E---v
----------X----------M--------------ME-------?------------M----------------o----------------?-----------X----------E---B--------------------X-----E------------E--------------B------------------E------
--oX------X----?X---E------E----XXXXX---E----X------?----X--B-?-----X----X-E-E------?---------E---?-X-XXXE?E-------?XX------?------X?X-X--XXX--XX-----------??-X-o----?--EoE-o--?---?X--X--X-o------?---
--?XX---E-X--E-EXX---------?-----X?X--o--?Eo?X?----B---XX?B--?-E----X---X---B?-EE??E--o--?---------X---X------?-----Xo-------------EEX-XX-X-X--XX----------?BXX-----?-------E-?--?-EXEXX--MXXXE-o-------
-o-Xo----X---E?XXX--o------Xo---E-X-----??XXX---E--E-X-XX--------T-BEX-X----X----------?-----ooEo---MXX----E-------?-X-X-----??--E-----XX-XX----X-------E?---X?---E------?-----M----?XX-M---XX?-E-?--E?-
---X--XoX-XXXXE---X--------XXXX----XoM-----XXE?------XXX?--------|---X-Xo----X--?-?---------?XXX?---?XE-o----E--E-?---X----o--------?-X?X-X----X?--?-----XX-X?-------EE--?--?X-o-EoXX-Xo-----XX-E--B----
----X-X-X--XEEXEXX--T--X--?-XX?-o?-X-T|----?T--oX?----EX---?-E---|--X?X-XE-XX?---T---TT----E--X----XX---?-?-X---E--o--X--??T-----T--E-EX-X--?---X--?o--o--XX-X-------XX-X?----XE-?-XoX-?Eo-B?X-TT--E----
m--o?XXX??XXXXoX|XXX|X-MX-XXX-X-EX?-X||XX?X-|-EXX----|X---?XX|------EX?-X--EXX?-E|-B?||XXX?XXXX--?-Xo--X--??-XE---X--EXX?-||--??-|--E-XXXoXo-X-X-E?|-?XXXX-XX-?---?X--XX-?----X-E-X-oX---X-E--X||?--XX--
XXXXXXXXXXXXXXXXXXXXXXXXXXXXXXXXXXXXXXXXXXXXXXXXXXXXXXXXXXXXXXXXXXXXXXXXXXXXXXXXXXXXXXXXXXXXXXXXXXXXXXXXXXXXXXXXXXXXXXXXXXXXXXXXXXXXXXXXXXXXXXXXXXXXXXXXXXXXXXXXXXXXXXXXXXXXXXXXXXXXXXXXXXXXXXXXXXXXXXXX
