--------------------------------------------------?------?----------------------------------------------------------------------?------------------------?-----------------E------------------E---------
------?---------------------o-------------------------------------------------------------------------------------------------------------?--------?---------------------o---------?-----------E--------
---------------------------------E--------------------------?--------o-----------------------------------------------------------------------------o----------------------------------------------------
----------------------o----------------------E------------------------------o-------o----?------o------?----E-?-----o-----------------------------------o-----------------------------------------------
----------------o-----------------------------------------------------------E-----------?------E--------o--------------------------------------------------?--------------------------------------------
---------------------------E--------------------------------------------------------E----------?--E------------E------------o---------E-?----------------------------------------------------?----------
------------------o---?------------??----------------------------?----------------------------------?---------------?-------------------?----------------------------------------E----------------------
-------?--------------------------------------o------?-------------------------?--------------?--------------------------E---------o-------------------------------------------------------------------v
----------o------?-------E------------------?----------------o-?--------o------------------------------------------------------------?------o---------?-----------------------------------E------------f
---o-----------------------------------?--------------o------------------------------------------------?---------------------------------------------------------------------------E-------------------f
-------------?---------o---------------------?------E-------------?----------?-----------o----E--------E-----------------------------?----------------------------E------------------------------------f
----------------------------------o---------------E-------------------?----------------?------------E---------o-------------Eo-----E------------------------o------o-----------o-----------------------f
--------------------------------------------------------------------?--------------------------------------------------------?-------------------------------------------------o----------------?------f
--?----------------------?----------------------------------------------------------E-------------?-------------------------------------------?--------------------------------------------------------f
m------------?-|--|-------|-------------|------------|------|-------|------------------|-----------------------------------o-------------------------------------o--|-------|---?---------------|------X
XXXXXXXXXXXXXXXXXXXXXXXXXXXXXXXXXXXXXXXXXXXXXXXXXXXXXXXXXXXXXXXXXXXXXXXXXXXXXXXXXXXXXXXXXXXXXXXXXXXXXXXXXXXXXXXXXXXXXXXXXXXXXXXXXXXXXXXXXXXXXXXXXXXXXXXXXXXXXXXXXXXXXXXXXXXXXXXXXXXXXXXXXXXXXXXXXXXXXXXX
