-M-MB--o------E-o-E------B-----------------oE----oE----?-------E-------E--E-E--------B-B-------oo---------B------Mo--B-----B-----BM----------------M--------------oM----B--o-----o---?---o-----?--------
--M----M---?-------B----o------------B-E--------B--------B----Eo-B---o--------?--------E--------------------------?-------------------E----M-?----E-o--Eo-----o-----Mo---------o-----?-o------B----E----
--?-----o-----------------------B-----E-----E-------------??E--------E--------MM-?------M------E--------o--E------B---------B-oo-M----B-----?--M--M?-B-------o-----------?----------------o---?---------
-------M--------MB---------o-M-MB-----Eo?--oB---?---o------E--M------B-----??------------M-o-M----------------E--------?---------E--?-E--M--o?-----E----------B-?--------?-BEBM------B------E--??----M?-
-o--o----B-B?--------?--?--E----------?-----BEM----E----o-E-----------??-?-M---M---B--------M---M---?----------E-Bo---ME--M--oB?----E---------E--?---M----BM--------o--------------------E-B------------
----B---M---E---B----M--M-----------B---oo---M?---?--?-B-------M-o-B--oM-----B------BM------?---------------E-?--?---EB-----E-?-----M----??-----M-?---------o------oB--------M---B----------E--------E--
----B-B---------B-E---?-?---o---M---oE----E-o--------Eo-B----B---E-E--?----E--E?--------E-------------BE------M--M------Eo-E--B-?--?-------o---------B-----E----o--B--?--BMB----?-----E-----------B-----
-o------E--B-----M---M-?--M-----B--------------oo-E--E--?---M-------E-------M------------------E-----?--------------?----oo---E------?-?---------B?-?-??--------o--Bo----M--BE---------?-MM------o-----v
-?o--------o-B-----M-B--o-----M----------------------B--B--o-E---?-?-?--------B-o-B--Mo-E-----?-B--B-------M--o---M--B----------??------?-------------------o-------?-M--o----ooB-----E---B--?-?-o--?--f
---E---B-E-?------B--------?-------o----------?----------M?-------------?---?-o--?----Bo--------E-------------?-B------BB---------E-o----?-------------M-------o--------------E-M----E?-----M----EBB--of
------?--?--------E--------B--B--------?-------E----------oEM----EM---------B?--o-------B-M------E--------------M-?B--o-M-----------------EE-------E--E--EM--------------------------ME-o-oo-----------f
---------------B-----oB---o-E-------------B----M-------?----Bo----M--?-MM--?----BM--------M----?-------B-----B-MM-----?----------B-o-----E-------?---B-----M---o---------BM-M-----?oM--BE---------BM---f
-----------o---MMMBE--?----o?M----------------M---------B---M--------------?---M--o----B-?-B-?--?--M-------B----------E-----B--------EMEo---------o-------o------E-------oB---oM--o-----B-------M------f
--E----------------o-E------o---------------o--------o?-----BM----M-Eo----B----B----?-----B------M-M------o?----?-M-B-----?---E-------------------?------B-------o----X--?----M---?-MB---------------B-f
mBB--------------------?---------B|-------X--------M-E-M--?-------M---o-----?-B---B--B--X-BX-----o-X-------?oo-M--E--E---------X|-o--?----?X-------------|---?-------X-----?---|--?E---M----E|B-B------X
XXXXXXXXXXXXXXXXXXXXXXXXXXXXXXXXXXXXXXXXXXXXXXXXXXXXXXXXXXXXXXXXXXXXXXXXXXXXXXXXXXXXXXXXXXXXXXXXXXXXXXXXXXXXXXXXXXXXXXXXXXXXXXXXXXXXXXXXXXXXXXXXXXXXXXXXXXXXXXXXXXXXXXXXXXXXXXXXXXXXXXXXXXXXXXXXXXXXXXXX
