----E-E-----M---X-------B--o--ME------M-M--------ME-X----M-----------------?-----------------------E----------------B------------oE-----?---E---------------------BoEX------E-MB---B--------------------
-------?E---------------E?------------?-?-o--o--------M--------?-------M----X---------o-----?M---o-M----------E----------------M-----o-------BBo---------X----o?-o--X-o---o------B-----------?-MB-------
--E-------o------------------BE-M-X---------X--o?-B---------B-------E-E---?--------------X----o--------------------?------------?------------------------M--------o---X-----------Xo---B----X-----------
-----------------X--E--XX-----------M-o-M--------?----------------B--BE--?---M-B----X---M--X-X-X---o-----X--------B----?----X-B--M--------------------------M-B------M------EM-M-----MM-----o------M--M-
------------B----E------------------------o---oX----B--E--------?----M--------E--E------o------------B--o-oo-------E---------X------B----------o-----?----X-B-------------B----------?---BM---o------E--
-----X--------o----X----M----------------------X------X-o-----------------------?------o-----------------------oB-------------------o-----------M-------oE-----o----------------M--o--oM-----?-----B----
--B------?------o--------B----M---M?--o------E-----B----------------E-----------M-----oo---E-------?----X------------------------M---------------M------M---B-----------------X-----B-----------o-X-----
-----------o---------M----?--o-----?MX-----M------B-----X-M-----B---B--B-----B-XBM--E-M------X-------o-----M--X---------?---------XEM------?E-M--M----E------o--M---E----o----o---?---?------?M--X--X--v
-?-B-----M--E--?--o-------Eo-o------------------E--------M-------M---------------E-E--XB--------?--------M------B--------M--------------o--o---------o-M------o--------E-----------------------?-------f
-----X-----X--------XX------o-----E---------M--M-ME------------X--??----------B---E--------------o------M-------------?-------------o-----------M----------E--------B-ME-BM-?--------------------B--M--f
------------MB----------------------E--B---------B--o------B--?-----------B--------------------B--X-o-----B-o-----------E---E------------E-----M--B----------XX----E-X--o----E-B----?-X-Xo-------------f
--X--E--------------------M-----------M-------------E-------M--------X-----------------------------------------o---------o-?--------M-M----?E------------------?---B---E-o-----------X----o--------E---f
---------------o-----------XB------E---BM---?-X---E-------------E-----M----?M----?-------------B--o--------X--o----X--M-------------X----------E-----------------------M---------------E---------------f
-o-o------------o-o-------------------B---EM--X---o?--o--------?-----X------?-----------------X-------M---------------?-----------------------X----o-----M-----o----E-----E--------B------BM-----------f
m------------?------o-B----X-----E-X-o---------|---B---?----M-o---?---M?|--|----|---------E-------?-------M------|oM------B-------XE------M-------EX---o--|---B-?-------X----------B?--------------o--?X
XXXXXXX?X?oBXXoXXXXXXXXEXEXXXoXXXXXXXXXXXXXXXXXXXXXXMXXXXXXXXXXXXXXXXXXoXXEBXBXXXXXXBXXXXXX-XXX-BXXXXXXXEXXXXEEXXXXX-XXEXBXXXXXXXXXMXXXBXXXXXXXXXX?-XX-XXXXoXXXMXXXXEXXXXXBXX-X?XXXXXXXMBXXXXXEXXXXXXXXX
