------------------------?-----------------------------------------------------?------------------------o-----------------------------------------------------o------------------------------------------
--------------E------------------?----?-------------------?---------------?-------------?--?---------------------------------?-----?-E---o------------------?-E--------?-E-?o?----?---------------------
-?-------------------------------------?----------------------------?-------?------------------------------------------E------------------------------------------?-------------------------------------
--------------------?----------------------------------?---------------------------------------------------------E----------?-------------?----------------------------------------------------------?E-
-------------------------------------------------------?---?------E------o-?----------o--------------------------------------------------------------------E--------------------------------E-----------
--o-------?---?-------------------------------------------------------------------------------------------?-------------------------------?--------------------------------------------------?----------
------------------------?---------?---------?-----------------------o--?-------------?------o-E-----------------------------------------------------------------------E--o----------?-----------E-------
----------------------------------------------------?-------o-----------------?--?-----------------------------o------E------------------------------------E-------------------------------------------v
---------?--------------------------------------------?-------?--E----------------------------------------------?-----------?------------------------------------------------------------o-------------f
-------------o-------------------------------------E-----------------o--------------------E-------------------------------------------------------------------------------------------?----------------f
-----------------E---------------------------------------------------------------------?------------------E------------------------------------------------o----------------?--------------------------f
------------------------------------------------?------------------------------------------------------------E-----E-----------------------?---------------------------------?-------------------------f
----------------------?o------------------------------------o----?-----------------------o----------?E-----------------E---------------o---------------------------o-----------------------------------f
-------------------------------------------------------------------------------------------?------------------?--------------------------------------------------------------o--------------E--?-------f
mE---|-|---|----|--------------|--------|-|----|------|-o---------?----------------------------||----|---|-------|-----------|--------|----------------o--------|----------o---------------|-----------X
XXXXXXXXXXXXXXXXXXXXXXXXXXXXXXXXXXXXXXXXXXXXXXXXXXXXXXXXXXXXXXXXXXXXXXXXXXXXXXXXXXXXXXXXXXXXXXXXXXXXXXXXXXXXXXXXXXXXXXXXXXXXXXXXXXXXXXXXXXXXXXXXXXXXXXXXXXXXXXXXXXXXXXXXXXXXXXXXXXXXXXXXXXXXXXXXXXXXXXXX
