--------------------------------------------------------------------------------------------------------------------------------------------------------------------------------------------------------
--------------------------------------------------------------------------------------------------------------------------------------------------------------------------------------------------------
--------------------------------------------------------------------------------------------------------------------------------------------------------------------------------------------------------
--------------------------------------------------------------------------------------------------------------------------------------------------------------------------------------------------------
--------------------------------------------------------------------------------------------------------------------------------------------------------------------------------------------------------
--------------------------------------------------------------------------------------------------------------------------------------------------------------------------------------------------------
--------------------------------------------------------------------------------------------------------------------------------------------------------------------------------------------------------
-------------------------------------------------------------------------------------------------------------------------------------------------------------------------------------------------------v
--------------------------------------------------------------------------------------------------------------------------------------------------------------------------------------------------------
-----?o?X-----EoXX--oo-X---X--X---------XX?EXXX-E----oX-?---XXE----XoE?-----E?-------XX?X----o-?-------E------?--?o-X------X-X-XXXX-XXX-X?XX-----??----E---X?X-X-X---------?---?E-------E--oX------XX---
--o--XXXX---?----X?---?-XXX-?XXX?--------XXXoX-?o-o--XE--X?XX-----?-X-E?------?--?E---XXE---X-X--?-o--------?------X---?----X-XX-X-XX--XXX-X------??-XX?--?XXo-oXX----------?-?----?----EEo?-X-o-?EX?X--
------XXX------?-XEo-----X---Xo-X-------?-X-X-?-?-?--oX?E-X-X?--E?oX----------X-o------X----X?-X--E------E----------XX---o--X--Xo-XX?-o?X-X?-?-------X---XX-X?---X-X?---E?---EXX---E-----?E---X----X?X--
-----?-X---------XX-----EX---XX-XoX------oXX----------EXXX--EX---XXX----?---?X------?-X---?--XX----E-----Eo---E?--?XXE?--X-X-E?XX-XX-----XXXooo---?--X---?XX-?--o-X-oE-?---E?-XE----??-------E-X--??Xo--
--?--oX-XXX-X---XX---??-E?Xo-?X-XX--------XXXXE?Eoo---XEX-?-X--XX-EX?---?---X------?o-X-?-?EXX-?-XX-o----EX--oEXX?EX---?--X----XX-oX-----X-X-?---E-?o-X---X-XE---XX--XXEo--?-EX----?o-o---E?--X--X?XXX--
m-oX-X-?XEXX?-XEX?Xo-?oXEoXX?XE-X--o-------XXX-?XE?--XXX---X---?X?XX------?X?---?----E-XX-X-X--?XX-------X-X-X-XX-X--XXo-X-----X-XXoo----EX?Eo-X-X?XX-EXoX---X?-EoX---X--?-----XXXE--XXX-E-XX-XXX-XX-X--
XXXXXXXXXXXXXXXXXXXXXXXXXXXXXXXXXXXXXXXXXXXXXXXXXXXXXXXXXXXXXXXXXXXXXXXXXXXXXXXXXXXXXXXXXXXXXXXXXXXXXXXXXXXXXXXXXXXXXXXXXXXXXXXXXXXXXXXXXXXXXXXXXXXXXXXXXXXXXXXXXXXXXXXXXXXXXXXXXXXXXXXXXXXXXXXXXXXXXXXX
