--------------------------------------------------------------------------------------------------------------------------------------------------------------------------------------------------------
--------------------------------------------------------------------------------------------------------------------------------------------------------------------------------------------------------
--------------------------------------------------------------------------------------------------------------------------------------------------------------------------------------------------------
--------------------------------------------------------------------------------------------------------------------------------------------------------------------------------------------------------
--------------------------------------------------------------------------------------------------------------------------------------------------------------------------------------------------------
--------------------------------------------------------------------------------------------------------------------------------------------------------------------------------------------------------
--------------------------------------------------------------------------------------------------------------------------------------------------------------------------------------------------------
-------------------------------------------------------------------------------------------------------------------------------------------------------------------------------------------------------v
--------------------------------------------------------------------------------------------------------------------------------------------------------------------------------------------------------
----X?-----?E----------??-?----?o-X?--?E-----?------o--?-oE------X---------?-----E---EX-----XX-E---X-EX-o---XXX-E--E?-EE-X---oXoE---?-----EXXXE?-o---------o---?-X-?-?o---X--E-X----?----------?-EE--X--
---?EX-?---X------------oX?---E--?X--X----------E-----------ooE--X?XX------?----E-----X---??-XX---?-XXE-?E--oX-----------X--oEEXX----X--?---XX?---E--------------?X--?o---X-EX-X----E?-------------EX---
---oX--o--?-X------o----X?---?-?---XX----E-----o-----------?-?Eo?XXX--?E----?X--?----X--?----X------X-------X-o--o--------X-XXoX--?--X-E-X--oX-------?--?--o-E----XX?--oo--X--X-----o-----E-o?------XX--
----X-?---Eo?X-?--?------X--XE----TX?--o-?----o-------?-X-----?-XX-XX-----?-XE---?--X-------??X?---X?------oXX-----E-?-EE-?X--X----o--XXX--E?X-----??--E??Eo?E----XXX?X--?Xo--?X??-E-oT--------oXX-XX---
----XXX--X-?X--|---X---?X-?--XX---|-X?X-E--?--T--o---X--X---?X-X-?XXE-?T--X-X--E--oTX-XXX-T-X-X-XXXo-?----?XX?X-T----XX-?E-X-XT-o--?--TX-X-E?X?---------X--?EXX--T-X??XXX--XX--X-XXE--|E--T--T?-XXTXo---
m-?XX-?X-X-?X-X|X-XX|?---XE-X-X?--|o-X----|o--|--E---?XX---?|X-|XXXX?-||?-X?X-----||-XoX--|--X---Xo--ooo-E|XX|-X|X-XoX--?---X-|?--X|--|XX-?-Xo-?X-X---X?X--XX-XXX|-X--X-XXEXXo-EXoXE--|--o|--|--X-|-X---
XXXXXXXXXXXXXXXXXXXXXXXXXXXXXXXXXXXXXXXXXXXXXXXXXXXXXXXXXXXXXXXXXXXXXXXXXXXXXXXXXXXXXXXXXXXXXXXXXXXXXXXXXXXXXXXXXXXXXXXXXXXXXXXXXXXXXXXXXXXXXXXXXXXXXXXXXXXXXXXXXXXXXXXXXXXXXXXXXXXXXXXXXXXXXXXXXXXXXXXX
