--------------------------------------------------------------------------------------------------------------------------------------------------------------------------------------------------------
---------------------------------------------------------E-----------------------------E---------------------------------------------------------B------------?------o----M-------------------M---------
---------o---------------------------B-E-------B-M------E-----------------------------------M--o?-----?------------------------?----------------------------E-------------------------------------------
-------------------------------------------------------------o--------------------------------?-----------------------------------------?---------------------------M------------?-------E--------------
------------E----B----E-------------------------B---------------?----------E---------------------------------------------------------E---------------------------------E-------?------------------------
-------------------M--M------------B------B---E-----------------------------------------?------------------------------------M------?-----M-----B-------------?-----------------------------------------
------------B----------------------------------------------------------?--------------------E------------------------------------------------?------------M-------E----------------B--------------M-----
---------------B-----------------------------------------?M----------------------------B--------------------------------------------------------------------------o------------------------------o-----v
--------------E-----------------------------------------------------------------o--o---------------------------?----?-------------------------------------?--------ME-----o------------------o----------
--M---MMB--B--?M----B-E--MB----B?---E-------E---M------E---?-?---E--E-M?------o-----------E--------E------o-----M-B---?B-E---------?----??oo-----B--B-B------B-----------?o-?-----E---B-?B--------------
------------MB----M-----o---?M--?--------------B?Bo-E---M-B-M------M?-----------------?o-EE-----E---------B--B------oB----MB-o?-----E---o--B-M-----?--?---o?-E-o----M-E?----BE--?---------E-?Eo---------
------X-o-B--M-M------B----------E--------M--M--X--E-----Mo----E--------o-E--BB--o-----------E-----E------o-E--M-B--Bo----------?---?B---------B-----------BM---o-?B--E-E---?----B----?---?----B--------
--E--X-----M------------M----?--?--B-B-?-------XX--X-?-M----o---M-o--BB---B-E--B-----E-----E---M-----?---?---B-----o---E---Bo------B-----?---M--M---o--EE-B---E-BB---?--------Eo-EB-----o----E---ME-----
-----?XXMM-X-M-o-B----------ME--B---Mo-----M?--X-B-X----o--------MooE-XX-X-E---BX-?--?E----XEB-?M----Mo---o--MEXX?-----B----E------M-BB-B----------o----M-?o----B-?--MBB?-----MM------oX-Eo---?-M-------
m---XM-XEoX---B-------X--M----B-----M-X---o----XB-XX--B--o--o-B---X--XX?-XE----X-o--E--X--B--Xo-B-----o-M----M-X---X-XX-X--------XM-oo---?-BB-----?--M-Bo|EMX-E-----E--X?---M--X------X------------Eo---
XXXXXXXXXXXXXXXXXXXXXXXXXXXXXXXXXXXXXXXXXXXXXXXXXXXXXXXXXXXXXXXXXXXXXXXXXXXXXXXXXXXXXXXXXXXXXXXXXXXXXXXXXXXXXXXXXXXXXXXXXXXXXXXXXXXXXXXXXXXXXXXXXXXXXXXXXXXXXXXXXXXXXXXXXXXXXXXXXXXXXXXXXXXXXXXXXXXXXXXX
