--------------------------------------------------------------------------------------------------------------------------------------------------------------------------------------------------------
--------------------------------------------------------------------------------------------------------------------------------------------------------------------------------------------------------
-------------------------------------------------------------------------------------------------------------------------------------------------X------------------------------------------------------
-----------------------------------?????---B------------------------------------------------------------------------------------------------------------------------------------------------------------
--------------------------------------------------------------------------------------------------------------------------------------------------------------------------------------------------------
--------------------------------????---------------------------------?----------------------------------------------------------------------------------------------------------------------------------
--------------------------------------------------------------------------------------------------------------------------------------------------------------------------------------------------------
-----------------------------------------------T--------------------BBB--------T-----------------------------------------------------------------------------------------------------------------------v
-------------------------------------------?---|-------------------------------|----------------------------------------------------------------------------o------------BBBB-----XXXXX----------------f
-----------------------------------------------|-------------------------------|-----------------------------------------------------------------------------????????----------------------------------f
---------------------------------------X-------|-------------------------------|-------------------------------------------------------M---------------------------------------------------------------f
------------------------------BBBBBBB--XX------|-----------------------XXXXXXXX|-----------------------------------------------------------------------------------------------------------------------f
---------------------------------------XXX-----|-------------------------------|-----------------------------------------------------------------------------------------------------------------------f
---------------------------------------XXXX----|-------------------------------|--------------------------------------------------------------------------------------------------------------------o--f
m------------------------------E-E-----XXXXX---|--------E------------E-X-------|----E---------------------------------------------------E----E--------------------E-E----------------------------------X
X----XXXXXXXXXXXXXXXXXXXXXXXXXXMXXXXXXXXXXXXXXX|XX-----XXXXXXXXXXXXXXXXXXXXXXXX|XXXXXXXXXXXXXXXXXXXXXXXXXXXXXXXXXXXXXXXXXXXX-BBB--XXXXXXXXXXXXXXXXXXX-----XXXXXXXXXXXXXXXXXXXXXXXXXXXXXXXXXXXXXXXXXXXXXX
