-----M----------------------------?----------------------------E---------------E----oo---------M-----B?---------------------------------o---------------------------M-----M-----------------------------
---------------------------------------------------------B-------------------B-M--------------E--------------------------------------E-ME-M-----------------------------------------------------------B-
---------E-----------------B---B-------------M---------------------------B-M--------------B------------------------------------B----M-M---E---B-?-----------o--?-------------M--------------------------
-----------------------------------------B-------------------------?------?------M---------o--o------E-------?E---oo----------------------E--------?-------B-----------o---B--------o---------------?---
----------------B------------M--E-----?--------------M---B----?--------------------------M------M----------------------------M-------?-------B--E----------E-------------B---o---E-----M----------------
--?E---??---------------?M---------------------------------?-------------?-----o----?-----------E--?--------------------EB---------------------M----------------------?------B---------------B----------
---------E---------------o----------E--B-----?-o------o--E---------------------?-------?---M---------?-----------------------------------?----------------E--E---------E-------------------------M------
--------------M--?MM-------B-------B---E----------B---M---B--------------B-o--------------------Eo------------B------o---B-----M-----------------M-----------------------M-----?--------------o-E------v
-o-MME-?---??o-?--B-----oE-?-E---?E-?---B--MEE-o-EEM-BM--B--B-M?-?o--?--B-?M-M-E-B-M-?BMB??---oE----oBB--Bo--?ooM-B-E?---MEE-M-E-M-ME---BB?MEEE------M--M?M-EMo?-MM?oM-----B-?BoM----BMEooM-?----?-M--E-
--?o---B-B-E-E---??-MB------E---?---B----M-?B-E--MoE-?E----B--M-M-o--EMMM-M-BM-EE-M----?E-E---BE-B-M--?B--M?--o--M-Mo--?---Bo--MMM-Bo-?EEo?E-o-ME--o-B-M-B?-M-?oo-E-B-B?-EB--?M-E-?-----E-MM-?----B-E?--
-----o--ooM-E-B-E--EM?oM-o?E?----B--BBM--Mo?oE--?oo-EE-o-MBoM-E-----B-B-B?M?B-EB------?E?M--Eo-o--Bo-oE--?E--?--o-B--?-EMM?o-?--MoB?B--MMMB-E-o-B-M--B--oo---EE--?--E--EM-BE---oEM?E-----?--?ooo--?-B-?-
--?---Bo---oE-EB--EoM?BE--?o--E-ooBE-E-M-oMM--ooBEoE--E---?-o?-BME-o-M?-B?----MBBB-oB-E-oM-o-M------M?o----M--B-oE-----E---M-EoM-MM-?-Mo-o-M----oo----o-B--o--B---B--?-?-------EB??o-MM?-?-----M--??--E-
-MB--?Mo-E-E-o-BB-E--B?BEMoMoo--oo-E-BM--EM--?--MoM?o?o-EB--?-MB-----B-EE---?ooo-----???-?ooMoEBE-M-BM-----MB?-EE--o-o-BME?--BM--oM---oMB?--?-------o-EM-MMB--o----o--o?o--?M??-BEM----M-B-oMB--oB-E-BE-
--B-B-??EBoM--MBEoo?oEMB-E?-E--MM----E??--o-E-E--M-B-?XMB-ME--o--B--B-EE?B-oo?EE-XBMB-M--B-o?-BooME?M?-----?--M-?M?-M-?B?--M-MB?-EE?-BE--B---EBoEooEE--MM--B--BM-BoBME----E--?---MB--o--BBB---EMM---o---
mMXXB?M-M-E|-XBoo----|?-??-?MEEM--|-o-M---X|M|X-oM---BBX-BEM--?E--EE-oX-?-oB--EM-XMEBXoM-|----X?Eo-E|X-?o|-X-|--?||-X--E-|---|--oXX--X|-o-|M--|--E-??-B--X-B--M?-?Bo-MoM-oEo--oXoB-o-MB-|B-BE-XoXo---B--
XXXXXXXXXXXXXXXXXXXXXXXXXXXXXXXXXXXXXXXXXXXXXXXXXXXXXXXXXXXXXXXXXXXXXXXXXXXXXXXXXXXXXXXXXXXXXXXXXXXXXXXXXXXXXXXXXXXXXXXXXXXXXXXXXXXXXXXXXXXXXXXXXXXXXXXXXXXXXXXXXXXXXXXXXXXXXXXXXXXXXXXXXXXXXXXXXXXXXXXX
