--X------------------------------????????---------------------------------------------------o-----------------------------------------------------------------------------------------------------------
-------------------------------X---------------------------------------------------------------------------------------------------------------------------------------------o--------------------------
-----------------------------o--------------------------------------------------------------------------------------------------------------------------------------------------------------------------
--------------------------------------------------------------------------------------------------------------------------------------------------------------------------------------------------------
----------------------------------------------------------------XXXXXXXX--------------------------------------------------------------------------------------------------------------------------------
--T-------------------------------------X----------------------------------------------------------------------------------------------------------------------------????????---------------------------
--|------------------------------------XX---------------------------------------------------------------------------------------------------------------------------------------------------------------
--|-----------------------------------XXX-----------------------------------------------------------------------------------------------??----------------------------------------------M-----X--------v
--|----------------------------------XXXX-----------B-----------------------------------?o-------------------------------------------------------------------------------------------------------------f
--|----------------------------X----XXXXX----------------------------------------------------X-X---------------------------T---------------------------------B-----------------------------------------f
--|-------------------X------------XXXXXX-----------------------------------------------------XX----o----------X-----------|---------------------------------M--X----------------------------------T---f
--|-------------------------------XXXXXXX--------T------------------?------------------------XXX--------------XX???????----|-----------------------------------------------------------------------|---f
--|------------------------------XXXXXXXX--------|------------------------------------------XXXX---------o---XXX-----------|-------------------------T----------------o--------------T-------------|---f
--|-----------------------------XXXXXXXXX--------|--------------XX-------------------------XXXXX????????----XXXX------X----|-------------------------|----??-------------------------|XXXXX---X----|---f
m-|----------------------------XXXXXXXXXX---o----|--E--------------------------E----------XXXXXX-----------XXXXX------XX---|-------------------------|E----------E-E-----E-----------|---E---XX-X--|---X
XX|XXXXXXXXXXXXXXXXXXXXXXXXXXXXXXXXXXXXXXXXXXXXX-|XXXXXXXXXXXXXXXXXXXXXXXXXXXXXXXXXXXXXXXXXXXXXXXXXXXXXXXXXXXXXXXXXXXXXXXXX|XXXXXXXXXXXXXXXXXXXXXXXXX|XXXXXXXXXXoXXXXXXXXXXXXXXXXXXXX|XXXXXBXXXXXXX|X--X
