--------------------------------------------------------------------------------------------------------------------------------------------------------------------------------------------------------
------------------------------?--M----M-----B------------------------------------------o------------E----------------?------------------------------------------------------------B----B----------------
--------------E----------------------ME----B--------------BE----------------------------------------------------------------------?-------------------------------B---o-o-------------------------------
------------------------------?ME------------E----------------------E---------?--------?----------------------------------o----------------------------------------o---------------------?--------------
----------------------------------------------------------B------------M---------M------B--------------------------------------------------o-------------M---------------E------------------B-----------
-----B------------?------------------------------------------------B------------------E------------?----------------------------------------------------------------------M--E--------------------------
--------------------------?---------------M--------------------------?---------------------------------E----------------------------------o-------------?---------------?-------------------------------
-----------------------------B----------------B--------------------------------------E--B---------------------E-----B------------E-------------------------------------------M-----M-------------------v
------------------------------------------------------------------------------------------------?--o----------------------------------------------------?-------B-------E------------------------------f
----?------o---------------------------------------E-----------------------M----B----------------?------------------------B--------------------?-------E---o---------?---------B-B----------------B----f
-----------M---------------------------o---------------------------------------o---------------------------------o------------------------B---?----------------o----------------E----------------------f
---B---------BM--M----B-------?---|E----M--------B---B---M------------------------o---------------------E-------------------------B--------------------------E----------------?---M---------o-----B----f
--?-------------?----------|------|----------------------------------------------------?--------------------------|------------B-M--------------------------------o---------------------------M--------f
---------------------------|------|---E--|---------------------B--|-o-------M---------------?----o-----o----------|------------------------------------------------------------------------------------f
m----------------||------|-|------|----|-||----||-----|-----------|--------------|-------|-----|------|-----|-----|--------------|---|------|-||-----|----|----|-----|-------------|-------|-|-|-|-----X
XXXXXXXXXXXXXXXXXXXXXXXXXXXXXXXXXXXXXXXXXXXXXXXXXXXXXXXXXXXXXXXXXXXXXXXXXXXXXXXXXXXXXXXXXXXXXXXXXXXXXXXXXXXXXXXXXXXXXXXXXXXXXXXXXXXXXXXXXXXXXXXXXXXXXXXXXXXXXXXXXXXXXXXXXXXXXXXXXXXXXXXXXXXXXXXXXXXXXXXX
